-----BX------------------------------------------------------------E---------------------------------------------------------X--------------------------E---------B---------------------------------B---
--X----------------------?----------M--------X?---B----X---------E--------------------------------------------?----------------------------M-------------------------------------?----------E-----------
----X-----B-------------o------------X--------------o------------XX---------------------------------------------------------BB----B----X------------------------M------------M----------E---------o--o--
------------------------------------B-------------------------o--?----------------E-----------------------E-------------------------------o-------------------E----M---------X------------X--X----------
----------E-----------------M-----------------------------------------------------X?-------------E--------------X-------------------M-?--------------------M----B------------?--?------------------B----
-------------?--------------------E------------------?-------Xo---M-------------------------------------B--------M--------o---o-------------?----------------X-------------------?----------------------
-------------------------------o-X--E-------o-----------M----------------------------------------------------E----------?---?-----------------------o------B--------------------------------------------
-----------------------------------------------XX---------------------------------------------------o-----------------------E--------------X-oX-------------o----------------------B---------------X--Xv
--?--B----------------------------X----------------------X--------------------------------E----------------------------------------------?-------B--o--------XX------------------?---------------------f
---B------------------------------------------------------o---M-------B----o----?-------?-X---------X---o-----------------------------------------X-------o---------------------M-------------------X--f
-----------------------------------------------------------X--?---------------------------------------------E-----------------------------------------B-------------------------------M----------------f
------------B------M-----------------T----------------------o---------o-X-------------?-?--------------T--M--------------------------?--------------E-----------B--------M------?--E-------------------f
----------------------------------X--|---T-T--------------------------------M------------T-------------|-------------E-------------T------------------------?--------------------M-------T-------------f
---------------T--T--------------?---|---|-|---------------?B------------------------T---|----------?--|----------------o----------|-T---T-------------?---------------------------------|---T-----X---T
m--------------|--|------------------|---|-|--------T----------------T---------------|---|-------T---T-|-----T-T-------------------|-|---|------------T-------T--------------------------|---|---------|
XXXXXXXXXXXXXXXXXXXXXXXXXXXXXXXXXXXXXXXXXXXXXXXXXXXXXXXXXXXXXXXXXXXXXXXXXXXXXXXXXXXXXXXXXXXXXXXXXXXXXXXXXXXXXXXXXXXXXXXXXXXXXXXXXXXXXXXXXXXXXXXXXXXXXXXXXXXXXXXXXXXXXXXXXXXXXXXXXXXXXXXXXXXXXXXXXXXXXXXX
