XXXXXXXXXXXXXXXXXXXX
X13231321X231323132X
X231X2313XX3231d213X
X23XXX132X231323132X
XXX1321323c132XXX32X
X231213112111233X11X
X3133XXXX1232123XXXX
X112111X1211213e212X
Xa23223X2b232122123X
XXXXXXXXXXXXXXXXXXXX