--------------------------o----o--------?---------M------------------------XX-----------M------------------------------o------------------M--M------X-------B--------------------M----------X-----------
--------------------?-----------------X-----------------------X-----MX-----------------------------------M---E-M---------------------------M------------------------------------------------------------
-----------o-------------E------?------M--------B-------------------------------------------------?-------------------------------------E---------------------B-----------o--?----------------------X---
------------------------E--------------------------?--------------------------------------------------------------------------------X-------------------------------------------------------------------
--------------------------------------------------------E-o----------------M-M---------B----------------------------------------------------------------------------o-------------------------M---------
-----------------------------------------------------------------------------------------o-------------------B------------------------------------------------------------------------B------?----------
----------------o-E-------------------------------------------EB-------M------------------------------X----------------B------------------------E--------------------------------------------------o----
------------------------B-----------------M--------X----------------------------------------------------------------------------------------------------------B-----------------?-------------X------X-v
---------?------B----------------------------------------------------------------------------------------------------------------------?--------------------?---o----------------------------------X-T-f
---------------------------------------------------------?X------M------------------------------------------------------------------------X-X--------B-------------o---------------------------------X-f
-------------------------------------M--------------------------------------------------------o--------B-----E---------------------------------------------E-------------------------------------------f
-----T---------------------E------------------------------M------------------------------------------M----------EM---B-------------------------------X------------------------------X---------?-o------f
-----|-----------T-------------------------------o------------T--------------M------o------------------------------------------------------------------B---M---------------M--------E-----o------------f
-----|-----------|X--------T------------------?---------------|--------------------------------------------------------------------------------T----------------------------------------------------X--f
m----X------M----X----X----X-X------B--E--XX---X--X--M----X---XE------X----------X---XX-?----?--------XX------------X-X------X-----------------Xo---------X---------EM-----M------X---?--X----------B--f
XXXXXXXXXXXXXXXXXXXXXXXXXXXXXXXXXXXXXXXXXXXXXXXXXXXXXXXXXXXXXXXXXXXXXXXXXXXXXXXXXXXXXXXXXXXXXXXXXXXXXXXXXXXXXXXXXXXXXXXXXXXXXXXXXXXXXXXXXXXXXXXXXXXXXXXXXXXXXXXXXXXXXXXXXXXXXXXXXXXXXXXXXXXXXXXXXXXXXXXX
