MMEX-oE-oX---MXB--B-XE------M-EM?M-BoM?---o-o?M-X-?EMXB-B-BM------oM-M?-X?o-E-o--X-EM-X-X--XB-Bo?---o---?-?o--XEE---?E---EXM--?oo---M-E-?Eo?X--oBM-?--XM?--E---EB-E?XEEBE?E---oB--B??B-??--EMB-MXX---E-?
T--M?--o-EMX-XMoE-o?-XEM-MX-M--XEo-?-E?-B--EBB-M-M-----E-E--?M-Xo-o---oB----MMX--M-BB?E-E-EE-EBM?X?E-?X-B?M?--M-EX--?-Mo-?---X-o--?--M---ME-MX-BB--EEE---BoE-EoB----XM---o-oBX-B--E-M-Mo--Xo--M-E-ooXBMo
MTX-o-XM?E?-EM--T-oo?-X---EEo---?B-?M-E--X-E------E-BXX-E-X?E??---M----X--X-o?-B---T?B-M-MoEMME-EM--o?o---?M--oM--?-BE-E----ooo---o---BXX-M-?EX--o-E-B-oXEX-MB?M--?BoBE--B-X---E---E-?--M-?X-MM----B?--E
T|---B---B--o---|--MoXB----?-E--o----X-M--------o---Eo---B-B--o--?-----X-E------B-B|---X--M--o-X---------X----X--o--o?B-E-----M--?-o---o--EM--------E---TXM-oB--B-------X-?-------X?------M---X----Bo?-E
?X--o--EE------M|-?T-o---?--X-B----B---MX-?M------?M-BMX--M-E---E---XB-E-----?----EX--T?--M---M-EX------?-------o---B-------------?-E-o---?o??---X-X?---|ME--?----?-X---oM--?E---?B-?-------XM-----BM-oM
|------B--M-o--o|-o|-M--B?--E----X-----?--M---EXE-B-----?--Mo-E-E?M--E--o--X---?-----BX--M---M-ooo-----?-----X--B-----M-E------X-X-MM--------B--B-?-?--X|---oo---Xo---?-M---E-----?-BB-----XoE--o-X--M-T
T-o-T--E-EM-B--?X--|---o--X-------BEo-E--------B--?-------X?---T-----M-?--o-?M--o--BT---M---o-?M--M-------?-T---?---M----X---E--E--M-----E-oM?---M-M--BEX?----o---EE?XM-B--o-B-XT-o?-E-MX?-------X---?M?
To-?Xo---EB-B--B---|-?ET-----M--X---?----E---X-----E--ME---?E--|-----E---M-X-----?--|oXM---o---E----X---E---|--E--E----?-E----B--M?---BTE---E---M-T-----------B------B---M---M--XXB-X-----M--?--E--T-BEv
?MX------B-o---B---Xo-B|----T-B-Mo---XMB---X----B--B?EB--------X----TE-----E------T-|--?--B?--X------------?XX?-M--XXT-----o-?-XM------|-MEM--o---|X?-----E-----X--M---BB-?BXo---MM----?---X----E--|---T
oB--B-----------T-EB-?-|-E-EX----B---M--o?XEX--T-----------ETX?---M-X---?E-----o--|-|-oE--E?------M--X-------??---T--XM--?M--B---Eo--E-X---------oX-B??ME-------?-E----o--BM-?X----?---------------|B--?
M--?--?EB--XBMB?X?oB?--|--M--E-?-----M-X---o?EXX?MX---M-o---|--X-----X--B----BM---XBX--------X?--MBMM?-o-E---B--?-|B-o---M--oMoEB-----MM---BEX-oE?--MoB-M-X-B--M---------M--BM-B--T-E-E-E--Bo?-B-EE|--MX
-----M------E---o----o-X----?-X---X-----XB-T--B-------o-B?M-XB----X-B---oo---o---MoEB-ETM-B?---T-----M---------M--X----EX-----E----E?XoToT-B-M-EoB-X---?-M--?-------------B---BE-?|-----oT---T-M---X-?-E
?--------T-------------EM----T----M--------|-----?B------?o----------------T-?-------T-|-M-----XTo--------X-------TTB-B----MB----T-?--?|-|B-M----E---X--o-E------B-----T-----B--o-X-T--?-|M--|-o-------|
|T-------|---------------B---|-----------oT|------------?-T------M---------|---?--T--|-|----T---|--?-----------X--||B--T---------|-T---|T|o-----B---o-----BT-----------|----------T-|---T|--X|------?--?
m|-T-----|-------------T-----|---------T--||--------------|-T------T-------|T-T---|--|-|----|---|-----------------||---|T--------|-|-T-|||----T------------|-----T-----|T------TT-|-|---||---|---T---T-B
XXXXXXXXXXXXXXXXXXXXXXXXXXXXXXXXXXXXXXXXXXXXXXXXXXXXXXXXXXXXXXXXXXXXXXXXXXXXXXXXXXXXXXXXXXXXXXXXXXXXXXXXXXXXXXXXXXXXXXXXXXXXXXXXXXXXXXXXXXXXXXXXXXXXXXXXXXXXXXXXXXXXXXXXXXXXXXXXXXXXXXXXXXXXXXXXXXXXXXXX
