oM?X-?-B-oEX--X-BBB-E--X-X---MM-XMXoM-o-M-?E?-M-EEBMo?BB-?-?X?B-B-EMX?B-oEo--MXoBBB---?-BE-Xoo--E-B--M?B??----?-o--EM--oBXoB-EEoX-?MXB--o----B---Xo-T--E?E-BX?---?----E-M?--Boo-oEM---E--EB---MBEooEMMoo
?XMEBB-B?EEMo-E-BBMB-----M-MEoE-o-Mo-EX-BEEE?XME-?XXM??--Eo--MXo??----?Xoo-?-Eo-X-Xo-B--o-?Xo-EME--?--BMXME-?-----?BX--X?MB?EE-E---MM--MEBM?-X----M-|Mo-EMo??-?oo-o-?M-ooMX--B?oBM-EMo-M---X---E-Bo-?E-o
-B?M--M-XM?B-B?o-B-M---X--oE?MMB-----?MXE-?oM-B-E-MXEBM-B-?o--E-o?oTE--B-?-E?EBMXB------M--?o--?XEX-MMMXB--M--B----ME-E-E--XX--EB-M--o--MEE--Eo--XE-|?o?Eo--EXX--MEo-B--M-M-MBX??--XoMXo-BXo-B-X--EB---o
XM--o---EM-X--E---E-o-?B?-ME?--M-?--M--------?M--B-ME-?-E--M-BE----|-E----------M--M--E----M-B?X-BB-E?E-Eo----E--E-oXM---EE--EB-M?-T---E-?o-XX--E---|-B-Eo-E-----oB---EX-?--E--X-E--B?-------XB-o?-----E
B-o-B---E-o-B-B--?---E?--E---XT------B-M--X?----X?--M-EoM------?XBEX-oE-E--E-MEo--M----X----o-----BE----o---XX-E--M----X---X-M----?|-E-----B?-B-MMMMX--E-BX-B-oX?--B---o---XE--M----E-B---E--B-X---B---?
MXBo---oo--B---EMo--?--??MM---|---ME--?M---?---------M--BE-E-------B---XM-?-?---E--X-?---------M-M--XB------B-E--X-----?----B---B--------?---------------M------------?---X-E---o-?M?-B-X-------------MT
o-Mo-------?B-E-------?---MM-B-o-Bo?-B-B-o--M-?------E-X----?B----E-?------XM---?M-BXB---?--X------X----------B---------o-----o---BXM--EX-B-B-E-?--MX-----T--------oE--X----E---M?-oE--------MoB?-o----X
B?--XoM----E--o------X-BX-----XB-----BX----B-----X--BM---M-------o---E-B-oo-o----Eo------B-XEX-M-?-EB--------X----?M--M---B-EEEMTE--oB-----XEo---XX-----E-XBo---?-E--------E-?-EE--M?-M?--?T----o---BB-v
M--ME-ME--X-?X--ooXo------X-Xo----X-XB--------B--M--MMo---M-M---XM---?---E----XB-o-E-o-o--X-B-E------X-X---X--BE---------?-M---E|B---E----X---X-------o--o-B----B---BX-MX------o?-?--o-BEX-|-----?-E---M
B-B--B--XE-MB---M-MB-XB-------oEEX-E--?E---M-------M---?-----X----BB------------oB-EBo----?-----E-?-----?---M---T--BMX--B-X-E--M|?-?-M??-----ME------XB--M-Eo-X?----M------?---o--?-?-Xo---|--------o--E
|---?----o-?BM---E---MB---oo--E--oM---B-----E-o---?-X?--o--?-BX--X?---?--X--?-?M----B-T----BBo------XX--B----M--|---B-B-----E---|-E-----o--------o-X----B---MB-----E---X---o----E?M-----X--|X-B------oMX
M------M----M------Bo----E-oM---XT-----E-----o?-E-o--E--o-B---B-----X---?-E?---EE--o--X-X-M-----E-B--?--o-M----BX--X---X----?-?---?-T-oX?--M-----M--M--X-----M-----??--o------B----------XMXT--------oX|
M-TBX-----o?M?---X--oM----?B--X-?|--?-?-B---T---ooM--E---o-----M-?B--E---??BMTE--EM--B--------B---BXX-----E---E-----TM-----X-oo-X---|-------XXM--EX--M-------B---T-M--?-M-TE------EBB-----M-|----------?
|M|M--BXET--Mo-oXo?-------T-E----|XX---X?--B|--------E--E-------T--B---Mo-E--|---?B--E?--oX-------oE-----B-M?B---EXX|---E--?--M----B|M--M-------M--??E--------B?B|--X--T--|??-?-E---o-o?----|B-oBM-----|
m-|------|---T------T-----|------|----------|--------T----------|------------|------T-------------------------------|--------T------|------------T--T------------|-----|--|-----------------|--T----T--M
XXXXXXXXXXXXXXXXXXXXXXXXXXXXXXXXXXXXXXXXXXXXXXXXXXXXXXXXXXXXXXXXXXXXXXXXXXXXXXXXXXXXXXXXXXXXXXXXXXXXXXXXXXXXXXXXXXXXXXXXXXXXXXXXXXXXXXXXXXXXXXXXXXXXXXXXXXXXXXXXXXXXXXXXXXXXXXXXXXXXXXXXXXXXXXXXXXXXXXXX
