-----------------------------------M----------------B-----------------B----------------------------------B----------------------------------------------------------------------------------------------
----------X----------------X-----X-------------------------------o----XX-------------X-------------------E---------------------------M-----------T------------------------------------------------------
------X-------------------------B-------------------------?--------------------------o-------o-------------X-------------------------------------|--------------E-E----------------------------B--------
----oo-----B------------------------BB----M----------------------o--B------------M-------------------------B-------------------------------------|------------------------------------------------------
--------------------------------------------------------------------------?--E---------XBM------------------------------------------------------XX-------------------------------X----------------------
-----------------------o---------------------------------------B---------------------------------------------------------------------------------------M------------------------------------------------
----------o-----------B------------------------------------------------------------------------------E----------o--------------------------------------------------------------?----?-------------------
--------M--------------------------------------------------------------------------------------------------M-------------------------?----B-----------------M------------------------------------------v
-----------------------------E----------?------------------BX------------------------------------------------------------------------E--------BB---------------E-----------------B-----------------X---f
-------------------?-------------------------?---------------------------X--------------?X---------------------------X------E------------------------------------------B-----------------------------X-f
-----------------------------------B-------------B-----------------------------------------?-----------------------------?X----------------------------------------------------M------------------B-M--f
-o---------B-----------------------------------------------------------------------------------M----------------------------M-------------------------------------------------------------?--X---------f
-------------------------------------------------------M?-----------------X--------------------------M------------------------------------------B-------------------B----------B-------------B------M--f
---------------------?-----X-------------------?----------------------------------------------------------------------------------------------------------------------------?--------------------------f
m--------------X-------------X----X-----X---X-------X------X--X-B--X----------------X-B-----X------X----X-X----?-------------X---o-----------XB---------X------------------------------X-------X-----X-f
XXXXXXXXXXXXXXXXXXXXXXXXXXXXXXXXXXXXXXXXXXXXXXXXXXXXXXXXXXXXXXXXXXXXXXXXXXXXXXXXXXXXXXXXXXXXXXXXXXXXXXXXXXXXXXXXXXXXXXXXXXXXXXXXXXXXXXXXXXXXXXXXXXXXXXXXXXXXXXXXXXXXXXXXXXXXXXXXXXXXXXXXXXXXXXXXXXXXXXXX
