----------------------M-----E--X--------------------------------------X-------------------------------------------------------E----------------------X--------------------------------------------------
-------------------------------------B----------------------------------------o-------?-----------------------B-----?-----------------------XX-------------------------------------------------?--------
-----------------------------------?-------o---------X-X------------------------------------------------------------------------------------------------------------------------------------------------
----------------------------------------------o------EM-M--T--X------------------------------------------------------------E----------B------------------------E-------------------E-----------------X--
---------------------X------------X------------------------|---o--------------------?--E-----------------------X-------M----------------------------------o---------BT--------BX------------------------
--------?----------------------------------------?--------XX-----------?--------------------------------------------------------------M------------------------------X-----------------------E----------
-----X---BB---------------------------------------------------------------------------------------------------------------------?-----------------------------?-----------------------------------------
---------------------------oX---------?---------X--------------------------------------------------------------------X---------------------------------------------------X--------------------------B--v
----------------------------------------------------------------------------------------------------------------?-------------------------------------------------------------?------------------?---?-f
------------------------------------------B-----------------------E------------------X-------E---------------------------------------------E-----------------------------------------------------------f
---------------B-XX----X---------------------------------?--------------------------o-------X------------------------------------------------------------------------------------------?----X----------f
---?--------EX-----------------------------------------M------------------------B----------X----E-----M---------X--T-----------EB----------------------------------------------------------------------f
-------------------------B-----------------------------------------------------------------?-----------------------|--------------------------------------------------------------------B------------X-f
--?-------------------M--------------------------------------------------------------------------------------------|------------------------T----E-----------------------------------------------------f
m----------oM-------------MMM--BX--------------X---X--X-E-----X------X-------XM--------------B------X---------o----X------------------------X------------------------------X----------------X-------M--f
XXXXXXXXXXXXXXXXXXXXXXXXXXXXXXXXXXXXXXXXXXXXXXXXXXXXXXXXXXXXXXXXXXXXXXXXXXXXXXXXXXXXXXXXXXXXXXXXXXXXXXXXXXXXXXXXXXXXXXXXXXXXXXXXXXXXXXXXXXXXXXXXXXXXXXXXXXXXXXXXXXXXXXXXXXXXXXXXXXXXXXXXXXXXXXXXXXXXXXXX
