-----M--------------B------------------------X-------------------B------------o----------M--------------------------------------------------------------------------------------B-----------------------
----------------------------------o--M------------------------------------------------------M------------------B------------------------XE-------------M--------------------------------------------B---
----------------------------------------------------------X------------?-------------------------M--------o----M--------------B------------------------------------------------------------?------B-----
-M-----------------E---------o-M------------------M--------------E-------X----------------------B-----------------M-------------------------------B---------------------------E-----oo---------------X--
----------------E-----------------------M---------------------------------------------------------------------------------Mo------------------------------------E-------------------------------T-------
--------------?------o-----------------X-----------------------------------------------------------------------------------M--------------------------------------------------------------M-----X-------
--------------------o-----------------X------------------------------------------------E--------------------------------------------------------------------------------------------o-------------------
---------------------------?-----------------?-----------------X-----------?---------------------------E-----------------------------------------?---------E-------------?-----------------X-----------v
----------------B------------------------E-------------------------------------------T-----------------------------------------------?-----------o---------------E--------------B----------------------f
-------------------------------------------------------------------------------o-----|----------------------------------------------------B---------------E--------X----------M------------------------f
------------------B-------------?--------------------------o-----------B-------------|--------------------------------------------------------------------------------M---B----------------------------f
--------------------------------------------------------------------?----------E-----|-------------------------------------?----------X------M---------------o-----------------?--------------------XX-f
---------------------------------------------------------T------------------o--------Xo------------------MT-------------------B------------------------------------------------------------------------f
-----oE--------------------------------------------------|----------M----------------------------------------------T-----------------------------------------------X-----------------------------------f
m-------------------------------X--------X---------------X---X----------------------XX---X-----------X----X--------XM?--------X-------X------X-----------------------------X------------E----o-X---X---X
XXXXXXXXXXXXXXXXXXXXXXXXXXXXXXXXXXXXXXXXXXXXXXXXXXXXXXXXXXXXXXXXXXXXXXXXXXXXXXXXXXXXXXXXXXXXXXXXXXXXXXXXXXXXXXXXXXXXXXXXXXXXXXXXXXXXXXXXXXXXXXXXXXXXXXXXXXXXXXXXXXXXXXXXXXXXXXXXXXXXXXXXXXXXXXXXXXXXXXXX
