?--X-E-EB-Xo?-E--XXBB-MEE-E-Mo-B-?MB?-oM-B--E---o-X--X--XM-?-ooE-?M--B?--?o--ooo--E---E-X-oMEXXB--EM-E-BoB-?MXoB-?EB?--o--BTB-EM--M---?----B--oEBEo-----M?--oE-M-?E--M--E-B-XoM---BE--B-EMBM--o-MB--??-E
T-M?B-------Xo?---X-BXMoX??o--B--oXTMX-EB?X---?------M-oE-----E-EX-X-E--oM-BB-EE-E-BX-X-?-B--BB--XEEMM---E?E?-MMo-B-?o--o-M|--oEE-Mo-?-?BXB----EB-BB??-BMoE?Booo--?-E-oBE---XX-E----XM----E---X-XXM-?--o
M-EM-------??-o-BoB----EoB?M-M----M|-X-E?----BXM--?--?EBM---E-oo-----B-BX?---EMXX-M--B---?----?--EM?E-M-??o-M--Eo-M--E-X-?-|B-M---o--?-EE-o-o??--o-MMB--oB-E-B----o--?B-E--o--X---o?-o--Eo-o---?--X-o?-M
-?------?X--E-E--?--T----------???M|?---B-------?-B-?-----o---B---E-----------B-------TM--o?---------X-----o?-XX???X--T----|-BB---E-T-?-----?---X---?---M-o-----o-B--M-----Eo--E?------?-----M---E---?-|
MB-----o-E-------E--|X-oE-?---X--M-Xo--------B-BM-o----X--B--E-M---B----E---X---o---EX|------B-E---X---oE-Mo----------|--TXX--T-EM--|-MM?---------X--------------M---B------------B-M-------MMM--E--o--|
|?ooB----MXX--------X--EB----M--B--------XEE-M----------o----M-M-oE--BB--?-M---o--E---|-------EB-E--M---E-T---------?-|--X--E-|E--B?|oEEB---------------MX-M--E--B--o--T--T--?-E---B-?X---X-o--B?-B----o
B-BM----M?B--X-Xo--oE-oBBM--X-B---B-Too--B-B---E-?-o--X?-oX-?-B--B-?M------M--B-------|?E---X-------?---o-|X-o--?-X---X-o---BEX-o--E|-o--Xo------B-EX----E---E---EB--E-|--|-E--o-?------oX-X-oM?Mo?EoM--
T-------T?BM-M-o--o---?o?--Boo-----M|-o-o--Eo-----oE-EB?o--M-?----X-B-----oB--B-M-----XE--B--X---M-----T--XB-------M--?-B--Mo?------X-M----?-------?--X---------TM--E--|-E|--?-EBM---B-E--T---MB?M-----v
B----B--|o------o-B-MB-----------XM-XEE----oo----M?------?---EX?B--oBo-?--E-oXo-BX---M--BE-B-?-B?-?-TX-X---------?E-MM?--X------B--MMM-X-E---o--oB-o-?-----o--o-|-oB?M-X--|B?-------------XE-o-?----MM-M
|----M--|?o--X-------B-?X-o-M----o-M?BE-o-----M--B----X-E-----o--M--M---M---?o--M--?BEMME--?---oEX-E|-X--Xo-M----M-MBB--o---T---E-------o-?XB-B?------?M------E-X--Eo----?X-------E-o----Eo--E-BMX-E---T
B----ME-|o----?-Bo--------oXE-?----EB---oMX---?---B--E-Eo-XE-X-?--B--?---?-X----------?-----------X?X---X--X-XE-------T-oEX-X--X---oX--M--o-------E-E---M---MMo--E?--B----B-E--B-E---X-M--?-o-?--M--EXMB
M-M---BBX-------------?-?BM-E---M----BM-----Mo-o----E----X---o------?--oM-o-T--T----T----?--T----------X------------M-X---T--------B-ME-----------o--XT---M-M-----M-M----?-------T--?E-?B--?-?-----EMT-B
E--------M-E-TM------o---M-----E--------B-B---X----M---X------B--------T--B-|-X|----|-----o-|-------X--B--B---------??T---|--M------------E----M------|-----o----MM-----T--------|--B--BM---o-----M--|--
M------XTMT--|-------Mo-X-------?--------E-X-----T-o--------------T-?-T|---o|--|----|-------|------TE--o---X----------|--o|-TT-XM-----X--EE----?E-T---|---TT------------X--------|-M----TB--M--------|-T
m-------|-|--|-T----T----------------------------|-----T-T--------|T--||-T--|--|----|---T---|------|-T------T-----T---|---|-||T------T--T--------T|---|---||-T-----------T---T---|------|------------|-B
XXXXXXXXXXXXXXXXXXXXXXXXXXXXXXXXXXXXXXXXXXXXXXXXXXXXXXXXXXXXXXXXXXXXXXXXXXXXXXXXXXXXXXXXXXXXXXXXXXXXXXXXXXXXXXXXXXXXXXXXXXXXXXXXXXXXXXXXXXXXXXXXXXXXXXXXXXXXXXXXXXXXXXXXXXXXXXXXXXXXXXXXXXXXXXXXXXXXXXXX
