-M--o??o--o?-?-?B-X-BE-??XE-X-M--oBE-EM-XT-MM--Bo---oEoo?BE------BM-----XBM-B--BXXB-M-E--M-B----B---X?oB------E--M---E-oX--M?-?M-XBXB-M?Mo-Bo?--oM?---oBMBM---oB--BX-??-M-XEX-?-BBBMM----oB----B--X-MoE-
o?--BEE?X-M-B---E-E---XB-XooTB-BX--M?----|?MEXEo--?E-B--E?--M--o-o-MXMEM-----o-B--BoM?---TMo--oE--oBX--EXo--oX-EoB--?o-XE-----E--?--??--E--B--------?---MXB-X-Eo?-E--M--EM---o-oMM---BB-?-------B----X?o
?XXB------E---EE-X--B--Bo-EE|-BoB-EoM---B|BB-??--EX---X---EBMM-E?o--M----E---EME---oX?E-o|ET-------oMB--X--M-?--?B-MEB-----?E--Mo--B---B--X-X?--M-?EX--?-oXo--?E----X-EBo?-----MX----M-----B-E-EBo-?---?
X----B---------------o--E?--|-?o--------M|-B------oMX-E---M---E------------------Bo-Eo---|-|-------M--o-M--B---EX--?E-o--?--?ET-----Xo--------M----MM-------------E--XM-BEo--XX-B-B?-B--BMBB---?-X-BX---
M-E-?--EE----XT--TTo-----B-o|-?----o---B-X?-X---X---E--BM----?--?B-----X----M-oo--M-T---M|-X-B?-Xoo-M--M-M-----E-------?--TM--|-o---------E--o-?-oB-M-EX--B--X-----X----M-----?oEo---Mo-E--oX--XXM-E---?
T--T----B-BEE-|--||--EE-M---X--EM--T--E----?-?M----oE-M-EEo-M---X-Moo--M-?B-------?-|-?--X-M--B--X-----Mo--------?X--oB---|---|-?BE---o--T-TM-------MM----?T--oM------o-o--M-E---oM-MB----?E--BB---M---?
X--|T-------ooX--|X---M?-T--B?-??X-|-M---B??----EBB-----XMB-B--oM??--EB-o---?E-?---MX-o-o-------E---o-X----------M--E-----X---|--oEBB--oE|-|--?--?--MM--X--|-----------B--------E--?--MBM-----o--B-EBM-|
??-X|MX---T-----XX-E-----|----?--EXX---?------X-------XX---X?---??--M--o-M----B---EE---?o----B--B-----BB?------o-E--X----B---BX---E-B-BX?X-X--o-----X-??E-BX--------X-o----XB----MB---BE-o-----?--M-B--v
?X--X--X-E|-----EM--?--EoX-o?-E--------------o--------B-o---M----------o-o-X-BB---E-E-o---X--?EB?-XE---E-o----XM-o------o---o-M-E-B---?--M--X?----X------EMBM-XE?BEE----EM---o--E-----BBM--X------B----T
X----o---T|-E-----E-XX---?-o------MX-M-B-----?--BM--Eo-M---B?----M--?-----MB?---oM-B?--?X--X-BX-E?ME--M--X?o----M-M-o-----E--------?E-o---o-----B-B?---o-------EM--B------X----oMB-E-----Eo--?B--oE-o--o
XoEB--EM-||BM-EE---?-BX-EXXo--B---------XB-o--E?E-M?--o-M-------EB----BE?-X----E-E-o-X---X--XE?---X?--E-M--?o---X----oEBo-M----------------o-X---B-----E-M----BE-X-EM-BXE-o-BB-M-M-MX-o-o----M--E--o---T
M--------|X--BM---TB---T---M-TB?-----------TT--?--MTX----T?-------------------ME---M---------BM--Bo-T-------X-------M--------T---T-E--M------T----------M---M-----M-B----T-X--?-B-B-EE------oT-----M-oTE
M--?-T-E-X-?------|--T-|-----|------E-M----||------|-----|T--M----T--o---------?--TTM------------T--|--E---BB---T------------|---|--MX-------|---T----T----E-----------T-|---B---------------|------T-|o
?T---|o-----------|--|-|-T-T-|T------------||--TT--|---T-||-------|--TT-------T---||-------T-----|--|-----------|--T---------|---|-------T---|---|----|T-----M---------|-|-T------TT----T--T-|--TT--|-|T
m|---|------------|--|-|-|-|-||------------||--||--|---|-||-------X--||-------|---||-------|-----|--|-----------|--|---------|---|-------|---|---|----||---------------|-|-|------||----|--|-|--||--|-|M
XXXXXXXXXXXXXXXXXXXXXXXXXXXXXXXXXXXXXXXXXXXXXXXXXXXXXXXXXXXXXXXXXXXXXXXXXXXXXXXXXXXXXXXXXXXXXXXXXXXXXXXXXXXXXXXXXXXXXXXXXXXXXXXXXXXXXXXXXXXXXXXXXXXXXXXXXXXXXXXXXXXXXXXXXXXXXXXXXXXXXXXXXXXXXXXXXXXXXXXX
