-------X----------------------------M------------X--------------------------------------------------E--------------------------------------------?------------------------------------------E-------X---
---o---------------------------------------------------M--------------------------------?----------------------------o---------------------------------------------------------M-----------?------B-----
-------------------------------------o-------------B----------------------X-o---------------E---------------------------X----------------------------M--------X--------------------------------------X--
-E------B------------------------E-------------------?-------------E----E----------------------------------------------?--X---M--------oT---------o--M---------M-------------------------------------X--
------------------M-------?------------------------------------------------------------------?-------o------------B--------XX----------XX----------------o-----o----------------------------------------
-------------------B--------M---------------------------------------------E-----------------------B-----------------o------B-------------------------------------------X-----?--------------------------
------------X-----------------------------------------------X---------------------X-------------------?-----------------------------------------------------------------X---------------------B------X--
-----------X---------------------------E-------------------------Bo--------------------------X------------------------B-------------------------M-----------o------------------------------------------v
---------------------------------------------X--------------------------------------------------------------------------------------M----------X----------------o---------------B----------------------f
-------------B---------------------------------------------------------------------E-----E--------------B-B--------------------------------------B-----o----------------------------X-------------M----f
----------------X-o-------------------------------------E-----o---------------------X---------E------------------?------------------------------X------------------------------------------------------f
-----o----------E---T------------------------------------------X--------------------------------------------------------B---------------------?-------B------------------------------------B----X---ET-f
--------------o-----|--T-------------------------------------------------T-------------------------------------------------o---------------------?------------T----?---------------B---------------T-|-f
--T----------M------|--|-------------------------------------------------|--------T-T----T---------------------------------T----------------------------------|-----------------T-----T------T-----|-|-T
m-|-----------------|--|---------------T------T--------------------------|--------|-|----|-T-------------------------------|---T--------T----------------T----|---------T-T----T|-----|------|-----|-|-|
XXXXXXXXXXXXXXXXXXXXXXXXXXXXXXXXXXXXXXXXXXXXXXXXXXXXXXXXXXXXXXXXXXXXXXXXXXXXXXXXXXXXXXXXXXXXXXXXXXXXXXXXXXXXXXXXXXXXXXXXXXXXXXXXXXXXXXXXXXXXXXXXXXXXXXXXXXXXXXXXXXXXXXXXXXXXXXXXXXXXXXXXXXXXXXXXXXXXXXXX
