BE?BX?B-----?EE--?---MB?-BXB--X--?-Bo-?X?E?MMBo--oM-BX-?-oM-X-MXBo?B-oE--B---MBXE-----?--oB?---E??----oE-E?X----oM-?M-EX-o--?-X--?---B?XMXBM??X?MM?X?--?M--Xo---?M-----EEMM-EE-XM-?oo-X---BX-?--?B--M-E-
---M--B-M-o-E---MMoo--EE-----?--M-EoB-EM--EMX-X-MMB?-----TMEB-E--M-M---?---o---oEB-EEo-X?BB---E-XX--M?---MooBB--oE-o-M-E?MMB-??-o-BXMB-B--B?B-o-M--o-X-M-E-BE?E-M--B-ME-MXM--o-BBE-?---o---E----?-X-BB?|
-----XBT--ME-ME------B-XM??---o--XXX-X---BEB?BE--Xo-?M--B|-----E----XBoEX----BB-X-o?-EB-oME-BEM--?-?-M-XBo---XMBMX--T--XX?-M---?M-E-M-o-EoM-MM------?B-X--?----?MMo-?TME-oTX--X?--M-?-MEB-XM-B-o--o--XBX
MB-E---|-X---B----?-----?------?---M-M---X-----o------XBB|o----M-X---?--X?-?-o--M?--?-TM---------X?oXM----M---M-----|?--o--------M--M-----B-?B-Xo---?-------B------E-|----|T-B----EXX-M--E?-----?--T--BT
M--M-X-X------------B?-o--?EMEB-----XB--EMX--------------|?-------------------Eo------|----?XEE--E?---X---M-----o--X|--oM-----o-----?X-----M-?--BB------EE---X-B-----X--X-||-------?-M--X--M-X-M---T---?
T---M----MooB----X---M---?--?---M?--B-X----M--EB----oo---XM-XM-M---------------MX--?--X---oEo---MMM-----X---o-B-----|-----o----?--B-o--X--E---------E----M----M----X------X|B?-?oB-M-BEM--Xo------XXo--?
oE-?o--?-----oX-?----?-B---B---BM-----o-------ME-X--?-oTM---o--E-E--B--oX--B--X-EXM--?-o----?---T?oB---E------------XM-?To-----M--T--X-E-X---E----XB--B--o---------?-M----B|-M-T---M-M--o------B-------M
E---?-?---B--M-?---X-T-EXT-----?--M-----?--?---BM-?-E--XB-BE-M-M----E?-T-----------?----Bo---o--X----XoT---B--------B-o?-oo-M-BM--|?--X--E?---o-E----MM-M-X------E-----oo--X-?-|-E----------?-MEX--B-oXv
M-B-EE--B------M--o--|---|E-B-TT--MB-M---X------E-M------E---E-?---?---X----E-?-------B---o-E-TX---EMM-|---?--?--EEo--?-X-----o-B-X--EM-----M-?----?-?M---T------?M-M?B-----E--|----X--??---?----o-----o
?------MM-X--o-o--oo-X---|----|X-----?E-B?-----EM-E-M--XM--E-----?---M-------??---EEX--o----B-|--------X--ME---X-B---?-M---X-E--?------?M-----B----------TXE----M--E?--MEXB---X|E--T-----X---BE--BB----B
BX---BMB--E----EB-------oX----XT-E--B-------X----MM----o--M---TT---?------o------EoB-B-------?|-o---B----M--B-oB-----ooEM-Bo-?---X---o-o-X---o------XEXX-X-BBE-E-M--B-?---o--MEX-o-XE-------Mo?-T-----E?
o--o--o-------E-B-----X------XoX-TB----E--T---ME--o-M----TT---XX-XME------E--------T?B-----?o-|XB--?-EX--B-o-T---?X--?---B----B-TBT------o?------o----T---T---ME--?-------M-o---X-----E---------|--o-M--
M-------T--T-------T---o--T------|?-----?-|M-T?----M-----|X--------?B----B---?-?-?-|M---------X-?--Eo-------E|B-o--X------------|-|-------B-?---------|---|o----TT-----M---X-T-M--XX-----E------T------X
X---E---|o-|-------|-----T|X-----|---T----|--|-T--------?|------B----------------B-|--M----E------------E----|?--M------M--M----|-|---------------T---|T--|-T---||T-Mo-------|------------M-B?--|T---TEo
m-------|--|-------|-T-T-||------|--T|----|--|-|---------|-------------------------|-------T----------T------|----T-----------T-|-|--------T--T-T-|---||--|-|---|||T--T------|---T--T-----------||---|-o
XXXXXXXXXXXXXXXXXXXXXXXXXXXXXXXXXXXXXXXXXXXXXXXXXXXXXXXXXXXXXXXXXXXXXXXXXXXXXXXXXXXXXXXXXXXXXXXXXXXXXXXXXXXXXXXXXXXXXXXXXXXXXXXXXXXXXXXXXXXXXXXXXXXXXXXXXXXXXXXXXXXXXXXXXXXXXXXXXXXXXXXXXXXXXXXXXXXXXXXX
