EXMo--EE-E----?EB-X??-E---XBX-B?---o?Eo-XM-E?-EMTEE--X--MBXEoMXX-ooB-B--?XM-E-----X----?-?X---M?X?X---ME----o-M-oE--o-EoEooEE-o-?oX---XXMB---EXM--M---?BB-o--X?X??-----XB-M-E-XEBX-XE?Xo-?B-BB-?oBB-M--E
E--M-o-E-B--MMXBXoE--?--EMEXM--B-TEoo-EXBoE---X-|B---XEE-Mo-?----?XB?BB-X---XXE--B---o--?o-BEMBEXo-EM-Eo?-X-o-o---EoEMoE---Bo?--oMB---?-M-BB?B-BX-XoX-oM-MBX--MXM-oMMM-EoE-o-----?-?o---E?o-?X--X-?-M--E
M-M--X----X-?EMMEB-Xo--X--BBM-?--|---?X-o-o?MM-E|?---Moo----EBM---oBBMEM---E?--B-o-?-XoME--MB--o-?XBEMM-MX--MBX-X-?-M?-M--X--X-M-oo-B-ooEo---?---?-?E-----X-?--B-T-XX-ME---EXE-MX-E---------E--o---Bo-o?
--B------E-------oo---XBM--X--M-B|E--M-E-XB-----|----Xo--?-E-------M?--M--??-----?-MMT---B-o--E---M-XE-----?---------?---X---o--X----oEo?--------------X-----o-oo|X-?----B-?-o----oXo?-X-E--M--M-------T
M-EE---B---o-M------M?-EE?--o---EX---M------??X-X-ME-----o---M-B---?o-------------E-?|--X-E-o?--B-EB-M---X--?---E-B----MXE-o-----o------?---E--------?-Eo---X-Bo-X-------M-----?-EB--------M--M--X--BMMT
---------o-------BX-E------M?----------T-----o-ME-?---M-X-o-?-Bo-?----M-?X--X----M---|-----M--EoE--B---B---oE----M-----BB-X-----BE--B-E---BT--------o----M-B--?-E--?XE--Eo-E----o---M---E--M------oB---E
B-Mo?-B---B----?------E-oB-E-M----X----|-----M-----X-o--T---o-----E-B-------MEEX--M--X--o---?-----o--B--X------?----MM---E---XME--BB--B--X-|----E-E------E---o---B--EM-BoE--?M-----M----o-X?B---MM--o-T-
?---MBE-X-------------------?oXX-BT-X--|-T--M----T--o-E-|---?MM-----M-o----MEoE-XB--B------X----EE-B-E-----E--oM--------------E-E--T?---BB-|--oE--T------B---------o-BM---B-o-o------B--M-?-E--?E-?-M-|v
T--M---EBX--M-o-oB--?-X----------o|------X---E---|--E--XX----E----X--o-M-X-----M-----T-----B--------------E---?BX-----M-----?X-BB--|-------|--o-M-|?-B--------E--?----oB-o---oM-M---X-XM--E----------X|-
B-o?--?-----?------------EB------M|----X---M?--?o|-B-B--B-BoM--------------X?o-M-Mo-?|--o-E-----X-X-?---o--B-----o-----EBB--M-B?M--X--M----X-Bo---X----MB-E---BE--------EM-B--E--?----B------E----EM?-X?
T?----B-?X?X--o-XEXo--E-M---EX?ETTXB------??M-M--XEM-E-M---oM---M----X-M-----E-------X--M---B--X-o----M-E-M---?----M-------B--B-M?M-B-------------E-X-E?-M--E-?-E?--ME---oB-----------B-M-o---o-----M-oX
M---------?-B-o--?B----MB-------X|---B-MM---?XTB------------?-----o??----E-?M-------o---o-----EE---o------B--?--X---M--?-----BT--?-------E----X-?oTBo----------M--MX?T--M-T---E-E----o-----M?--M-----E-X
ET?----EM------------T-M-T---E-?-X--o------B--|-----------B-------------?-TMo-B-----------------To---o-----X--M--------E------|----o---B----?M--o-|E-TM---ME-------o-|----|--M--T---BT----------------E|
B|---X---------------|oMB|T---------T---------|-----E-XX------------------X-?-B------X----------|-----X---T-----TT----M---E---|--T-?T--T-X--------|TT|-B?--TE--------|?---|---T-|T?--|---T-X----T---T--M
m|--T--------T----TT-|---||----T-TT-|----TT---|--------------------------T--------TTT----T------|---------|T----||---T-T------|--|--|--|-T-----T-T||||-----|----T----|-T--|---|-||---|--T|---T--|T--|--X
XXXXXXXXXXXXXXXXXXXXXXXXXXXXXXXXXXXXXXXXXXXXXXXXXXXXXXXXXXXXXXXXXXXXXXXXXXXXXXXXXXXXXXXXXXXXXXXXXXXXXXXXXXXXXXXXXXXXXXXXXXXXXXXXXXXXXXXXXXXXXXXXXXXXXXXXXXXXXXXXXXXXXXXXXXXXXXXXXXXXXXXXXXXXXXXXXXXXXXXX
