|-M--MEBE-E----?BX-X--E-XEE-EB-oBBo-?-E?-?--E----??M---B--M-M-oX-B-o??-Xo--E-E--EM---X--oX-o-BX-XBEMX--B--BMEoEo?--M-?EM?-o--oBEX-----E-oMoEMMXB--M--Eo--?---?--MM--MXo--?oEX--B--ooBoMB-EEX--BX-E--E-Mo
M-----M-MX-B----BT---E--M-?--------?----?--EB?BMXE?-EEXXo-E-E-X--?--E-o-M---?-MB-oMEMo--o-B-M?-?-?-?MXBMEE--M-oM-EXB--E---oM?--??-ooE?M-B?-X----?-?------EE-EX---o?EMBXX--B-EXXBM-o-MBB--M-oT-?Mo---o--M
ME-E-----MME?--o-|--X-B---?-?MB-XE-----??-E------M---------E------BMo--T?-o--E?----E-o--?---BME---X-M-BB-o?EE--M--?B--BEB---MM---M-?XEEM---------o---B?X------XMMT?X-o---B-X--?E--?--B--BM-B|----M-E-B--
M-BE---M-B-o-----|----M-------E---------M-X-MX-Eo---X----TXo-BEX---o?--|T--TE----------?------?---o---M---B---M?-?--E?-----ToM-B----T--X-----------------------M-|M-XMX-?-MM----o-------T-?o|o-M-?X----E
?-oB-T----B----??|TB---o---?---o?-------o-------M?------BX-----?--?----XX-X|-----B---------M------M-?-----?--BTE---E----M-EX---BEET-|-------?----o-E-------X-----|--?------o---M---?T---X---|---------?-
|---EXT------X---X|-o------B?-?---T-B-oE-M--ET---B-X--B--M-E-----?--o------Xo-E?--?--EE--o-E-o----??-B-XoT-T-o|----MX-E------E?---X-|-o-MB---T-------o--------B--X----------?o---EM-X---?---X-----E?o--o
X-----X-o?--?----E|--?-?----------|M-?-------X--E---oB--B-----?Xo----E-o?--?----B-?TE--M---?-?-----B--?BE|-X--XT-T--------o--o---E--|--------|----T-----------TB--?-----T--EMT-B--M----X-B--------M--E-T
E?B-ET--o------M--|-E---X---------|-B---M-----XX-M----M-BMB?-TM-E-E---------?-B-o--|-E-B-?-M-M-T-----MM--X---?-|-X----------X--EB-T-X--------X----|-----T-----|----B----|-?--X-M---------M---E-o-T--?--v
|-o-oX--------?---X-?Eo--X---?---B|-------?-B-?oo----?------BX-----M-----B--------EX----?--?TM-|---M-----?-E?--|-BM-XEXX--To--?EE-|---EX-?--------X--M-XX--XM-|-----TB--X?----B----?ME-----------X--M-?o
X?E---?---?---?----M--E---?-?M-B--X-B--X-o------E---MM--B--E-------E-BXo------o-E-EEM--B----|MEXM-----Xo-------|---TBoB?o-X-----o-|T-X-M-B------M-----XM-M---XX----o|E--o-------o?-E--Bo-?--E----------E
o-o-M---E--E-B-M---T--B--o------------MB--X-EEB---T--o--M---?--B-B-----o-----E---Too?-X-?XM-|-----??-XE------o-X-MEX?-?-M--?--o-?-XXXB-----Bo--M-----B-B?B---o?-----|-E--?-?B-----?o-X----?----BE-----o-
?--MM-o---T--??--M-|---E-T-XB-------o-----------EMX----------T-T--?-T----T-----oET--TE---?--X-----ME-T--o---T-BE---E--T?----T?--M---------B---M--------T-TT---------|----T----------------T---BT------BB
o------T--|?-------X-?---|----?-ET-----------------------TT--|-|-B--|----|-----T-|--|----M-----------|------|---------|-----|-------T------------------|-||----?----X----|------------oT--|--?-|------T-
E-T---T|--|--------------|---T---|--T-T----TT------------||--|-|T---|--T-|-----|-|--|----TT-T--T-X-M-|TT----|-TT----T-|----T|T-TT---|---------T--T-----|T||-------T------|--T--T-T-----|--|---T|T-----|E
mT|--T||--|T----TTT--T-TT|T--|TTT|T-|-|TT-T||---TT-TT-T-T||TT|T||--T|TT|-|-TT--|-|TT|TT--||T|-T|T--TT|||T-TT|-||--TT|T|--T-|||-||---|---T---TT|--|-T--T||||-----TT|------|--|TT|-|--TT-|T-|--T|||TT---|X
XXXXXXXXXXXXXXXXXXXXXXXXXXXXXXXXXXXXXXXXXXXXXXXXXXXXXXXXXXXXXXXXXXXXXXXXXXXXXXXXXXXXXXXXXXXXXXXXXXXXXXXXXXXXXXXXXXXXXXXXXXXXXXXXXXXXXXXXXXXXXXXXXXXXXXXXXXXXXXXXXXXXXXXXXXXXXXXXXXXXXXXXXXXXXXXXXXXXXXXX
