X?--o--MEEE--oooBM-BMEM----o?-EMo-ooo-M-B---X-MXX-MM-E---oEMX?o-M-?X------?M-B-?--?-o-?BE----X--oMoX-X-BM?---E?-?BoB---?M---M--E--B?M?------BXME-oEB?-Xo?E-?M-X-oBo-oX--?Mo--E?E--MB-X-X--X-B-M--MM-M?-B
T-X-EoEME----MB-X--M-oM-XM-BX-EoM--Eo-?E-B-----X--MBB--MEEE--BMB-EE-B-------M-E-?-----BX--EX--??--o--X-Xo-M-EBBo-M-M-Boo?-XB-?E-T--MB-Xo--B--B-X---M-?M-oMBMEB-----o-BB--?E?----XX-BE--E-oo---o--?-?EX-X
EMBoo--o----Eo-E?--M--?-?EEE-----Xo-M---o--o-E-----TM--oXXB-oXX-?-----o?--M--XXB-T---Mo?Xo-----BX--X---B--X------MEBMoX-oBM-BBE-|o-oM-XMo-B--X?--?---o-B---BXE-M-B--M----EB-EMXEEoMB?--X?o?M-B--B-X-oo--
TBB--B---B---------Mo--X--M-?BEo-M--?--Mo-----?----|----MX-X--B-?M---T----?-Eo-?-|--?B-M--o----?---o----X-?-X-E--EE---?--B-----B|-B-oB--T--X--o--?-?BX?--X----M-?o----B---?--BE-o--------------MoB-?M--M
|-----BBX--??-----T--X-o--M--E--M-o---B----Xo--M---X?-MoM----?oX----o|-?-E-E----MX-X----o---Mo---?X--?---?B---T-Xo-MT---B-----E?|-?Xo-X-|-----E------E-------B---MX--------E------?--M--X--X---T--BMB-BM
|-T--B-E--BM--?-o-|--EB--X---BXo?------X--------XB?-?-o--X-----------X-E--M---?B?---o-X-BXX-o-?M--B-Mo--------X-----|----X-?---MX?------X-----M-?--o------B-----------E------?--?-o-?-E-B-o--XBX-E--M---
o-X--?B---o--?----X-----E-?----?--o-MEX-EB--XB--B---------M-M--o---E-T--M-B---M----X--E--??-E-?B--E---BXE-?----o----XE--?M--?-----?--oBo-X-?-?-------E-E-?M-E-X-o-o--E-----XM?--E--E-?---X-B-B-----?---E
T------?BM---M--------XX----E--?XM----B---o----B----?----B---B-B-M-B-|-B-EB--BMEM-ME-Xo-B-----oE?X----------oM-o-M------MoE--?--EM---M---o--M-E----M-----B------B-o-------X----X-E-E-Mo---X-?-----?o?B-v
BX-Xo-M---M--TBB?---oX?oM--X--MM--M--M--------B-o---?-E---ME---------X----M-?--E-----M----ME-X-----------T-Eo--?--BB----?-oX-B-E----?---B---EoMB--?---o-oBXB-X---?EE----oX--?T---?--?--Eo?M---o-X-M?E--o
XB---oEE--?--|---MB-o-B----?EX-----------?---?--B--E--o-----M?-------E-MB-Eo------TEo-M-?o?----?o-M-----o|EME--M--?--M-?--M-XoMT-?XE---MB-E-----o-MEM---EBoE--E-----MoE------|---oX---oE-BM-E--MMM----oE
X-XM---M--B--|Mo--M-?----X--E----?--Bo---?MX-E-X---?-E--M-B--B??-B-o--B-?--o--X--EX--E--E--?----E-M----B-X?----??--o-BE-----o--X------X------MoX--MBT----B---?B-M?--E--B?M-X-X---M-BM-B-EB-XoB---M----EE
T------M-B?--XT--?--T--------BT-------E---B--M---T--E?BB-X-?----M-?-X--B--o--------X----o-E--------T-X-----M------T--T--o--------------X---M-o?---M-TMM-E-----??------T-T-T--------o----M?--T--BE--T---E
|--------o----|--BB-|---T---ET|-oM----o-EX-------|------X-E----Eo---TMX-----?o--------o?--B--------X---X-ETBoE----|MM|----?----T-------M??------o--T|-----M-B---T-----|-|o|----------EEE---B|M----E|----
M----E---E-EM-|--?T-|---|ET--||-----E-----B------|---T-------T------|-?---------------MT-----------T------|---T---|-B|-------E-|----------To-------||---T--T--T-|--TT-|-|-|o-------T------T-|-MXT?-|---?
m------T------|---|-|---|-|-T||----------T-T----T|---|T------|------|--T-T-------------|----T-----T|------|---|T--|--|---------|-T---T--T-|--------||T--|--|--|T|--||-|-|-|--------|------|-|---|--|T--E
XXXXXXXXXXXXXXXXXXXXXXXXXXXXXXXXXXXXXXXXXXXXXXXXXXXXXXXXXXXXXXXXXXXXXXXXXXXXXXXXXXXXXXXXXXXXXXXXXXXXXXXXXXXXXXXXXXXXXXXXXXXXXXXXXXXXXXXXXXXXXXXXXXXXXXXXXXXXXXXXXXXXXXXXXXXXXXXXXXXXXXXXXXXXXXXXXXXXXXXX
