---B------------------------?---?--------------------------------------------------------------X----------------------------------------------------------------------B---------------E-----------------
------------------M---------------B-----------B-----------------------------------------B---B-?-E----------------------------E---------------------------------------M----------------------------------
---------------?---------------------------------------?-----------------------M----------------X---------------------------------------------X------------------------E-----X----------------------X---
-----------------------------------o-----------------------------------------------X------------------------------?-------------------------------------------------------------------------------------
-----------------------------------------E---------------------------------------------------o--------------------------------------------E-------------B------------B---------M--------o-----X---------
-------B-----------------------B---------------?---------------------------------------------X--?--B--------?-------------------------------------------------------------------------------------------
--------------------------------------M--------------------B--------------------------------------------------------------X------------------------------X----------------------oB-------------------X--
------------B------------------------B-----------------------------------X------------------------------E---------------------------------B-----------------X------------------------------------------v
--------------------------------------E------BB-----------E-----------------E----------------------------------------------------------o--?----------------B-----------------E---------------------MXX-f
-----------?-------------------------------------------------------------X?---X----?------------B-----------------------oX-B------------------------------?----------------------------------------M---f
------------------------------------------------------B--------------------E------------M---------------------------------------------E-------------------------------------------?--?-----------------f
----------B----------------------------------E------------------------------------------------------------------------X------------------------E----T?-----------------------------------------------X-f
------------------------------------------------------T---------------------------------------------------------------------------------------------|B-------------------M?----------------------------f
------------------------?---------------------------M-|----------------------------------------?--------T-------------------------------------?-----|--------------------------------------------------T
m-----------------T---------T-----------T-------------|--------T-T-------T------------------------------|-----------T---------------------T-----T---|----------T---------------------------------------|
XXXXXXXXXXXXXXXXXXXXXXXXXXXXXXXXXXXXXXXXXXXXXXXXXXXXXXXXXXXXXXXXXXXXXXXXXXXXXXXXXXXXXXXXXXXXXXXXXXXXXXXXXXXXXXXXXXXXXXXXXXXXXXXXXXXXXXXXXXXXXXXXXXXXXXXXXXXXXXXXXXXXXXXXXXXXXXXXXXXXXXXXXXXXXXXXXXXXXXXX
