---------------------B---------------------------------------------------------o-------------------E------------------oX------------------------------------------------M-o------------------X--M-------
--------------Xo-------------------------XE-M---------------E------E-X--------------------------------o-----------------B--X------MX------------X------X--------------X------B-X---X--------------------
--------------------X---------------------------------?--------------------------B-----------------B---------------------------------------------o------?---?------------------?---------------------?--
--------------------------------------------------------------------------------------------------------------------------------------------------------------------------------------------------------
----XX-----X------------o-----E-----------------------------?------------------------o-----X----B------------------------------------------------------------------XX------------------------?----------
------------o---------------X-----------------------?--X------------------------------------------------B-----X----X----------------------------------o-----X----B--------------------------------------
-----------M-----------------X-----M-------------------?-----------X----------------------XX-----------------------?-----o---B-----------EE------------------------------------------B------------------
------------------XM-B------M--------?---------------------------------------------X-X----MX--------------------------------------------B-------------E------------------------------------------------v
-----------------------------------------------------------------------------ooX--------------------------------------------------------------------------------------------------B--------------------f
---------------------------?---------------------XX---------------------------------------------------M--M-------X-----------------------------------------B----------------------------------------X--f
-------------------------------?-----E--------------------------------------------------------------?-------XXX-?----------------------------o----X-------------------------------------------E--------f
-E----------------E---------------------------------?XX---------?--------------------------------------------T-------------T------------------------------T----------------------------o---------------f
-----------------------X---M-------------------------------------B-------------------------------------------|-------------|--E------T--------------------|----------------------------------------E---f
-------------------------------------------------------------------------------------------------------------|-----------T-|---------|----------To--T-----|-----------------------------------------X--f
m----------------------------------------T--TT---------------T-----------------T----------------------T------|-----------|-|---------|----------|--T|-----|---------T------------------T--------------T-
XXXXXXXXXXXXXXXXXXXXXXXXXXXXXXXXXXXXXXXXXXXXXXXXXXXXXXXXXXXXXXXXXXXXXXXXXXXXXXXXXXXXXXXXXXXXXXXXXXXXXXXXXXXXXXXXXXXXXXXXXXXXXXXXXXXXXXXXXXXXXXXXXXXXXXXXXXXXXXXXXXXXXXXXXXXXXXXXXXXXXXXXXXXXXXXXXXXXXXXX
