B-B-X?--?BX-X---B-Xo--?M-?-B?B--B---M?o-o--XE----EXMEX-Bo?Eo-Bo---oE--oEo---XXoE-E?----B??oE-XoBEB--Eo-E-?B----MBMX-MB?---EMM-B-----E--ME---?-oE-B?--MEM-?oBo--Xoo??-M--EE--oB-B-BE----X?E-EMB-XM-?XMM-E
E??Eo---M--B-M---XEo---?M-XB---M?o-B-B---?XMo-TMEE-M--BB--MXE--EE-Eo--ET-----X-X----EM---T-----EBE-XE??o?EMEo----?o----o-?--T--?--oB-oE-o?B-Mo-T-XX-BX-BE--------o-?-o---?-E-EoMXX-----?-E---B-EM-----?o
T-M-X--?-oE-o-BXT-oo--E-?Xo-EB---E--X--?-XE--B|X-B---M-EX-E-M-M--M-?-M-|---E--------EEMEB|-M------Eo--XB-oM-----X----o-X?X--|oE---BX--?M---X---|o-----?E------M-M-o-XE-MooEX-----oBMEEMM-T-??----?----?-
|--?-----X------|-----oE--M---o-------M-X-----|E--------B--TM---X----o-|----------o--XMXE|-----X----------B---TXXo---M-Mo---|--?EB----M----?--M|--E-X----X-X-X-B---ME-B----M??T?-BE-?-M--|----X--------T
M----M--o-o---?-XE------X----B--M--?E---B--o--|B-X------E?T|---o-E----BX--o-o-T-----o---TX--X------?M--E-B?---|--E-M-TE----XX---EM--XE-o-E-o---|--------o-------X------B-----T|-E--------|X-----X------|
B---E---BB---oo---B-----M-----?B--M-??M?-T--TEX-EM---MTB--XX-------------E----X-?-----B-|-----M--X-B----X-----XB?----|E-o-------M----?E-EBE--E-X--o?--------TBX-?-XE-----TE-BXXM-?X-----?X--o---?--?---M
B-?B--XX------------------B---To----Eo--?X--|--M---XB-X-E---------T--------B?----M------|--o-EB-M---B------E--TM-----X-X--?-EM--E----------M--E-------?---X-|--M--E-X----X-B----?-------T-B---B---B--MMo
---E?----------oTo-TX----o-EE-|-------------X---E---B--o--EEE-T---X-B-----EMEE-M--------X-?o?-M----M--E-B-----|o----?-----M-----B--------------EX--oEM--o-?-X----o?----MM-o-B-?--MEB-BBM|----MMo--M--T-v
ETB----Mo-T-?---X--|M---T-----|----T?--TX--?-----X-o-XB-------X-----T-?-------EB-------T-B---B-------?--------X---------MM----o-M---T--------BB---o---X--o---o----EBM?--E-?---BM----XB?-|M-----?-E---|--
o|-----?--|-?------X--M-|B----|E---|-?B|---M--?-E-------B--o-B-M-M--X?----oo----ME-T---X--o-X-------X-Eo--TEE------T-?--o---------E-|---------M--o-E--------B-MB-?--o------E------------|--EMX-B?---BX-|
X|E---oB--|?-?-?o?-??---|M---MX-M-EXMB-|BME-E------o--------E------E---?M----EM--B-X-E-M-M----E----M?Eo-M-Xo-M--X--X-E-----?X------EXB--M--B-Eo-----o?M--M-------?oEB?--M------o-T-ME--BX------o---o--E|
M|--EB---B|-------o-B---X?T-B------E--T|?-B--------T------M-T------------E---TM-T---------?-o----T-oB-----------E--------------B--Too--T-------X-o------?------------------B----EXT------TT--E-----o---M
MX--T--T--X-----T-------T-|-----------|X---T-------|--------|---X----M-T--M--|--|----------ETT---|-----T----------TT?--T---------T|B---|TT-----------T----------TT-------T--------|------||-T------?---?
M---|T-|-----T--|-------|-|T------T--T|--BT|--T----|--T-T---|----------|--o--|--|-------T--T|XT--|-T---|-T----T---||---|------T--||--T-|||------T----|----TT--T-||----T--|-----T--|---T--||T|TT-----T--T
m-T-||-|T-T--|TT|----T-T|-||------|T-||---||--|--T-|--|T|--T|TT-TT-T-TT|T-T--|T-|-TTT---|--||-|TT|-|T--|-|-TTT|-T-||-T-|TTT-T-|-T||TT|-|||TT-T--|T--T|---T||-T|-||T-T-|T-|--TT-|--|---|--||||||--T--|-T?
XXXXXXXXXXXXXXXXXXXXXXXXXXXXXXXXXXXXXXXXXXXXXXXXXXXXXXXXXXXXXXXXXXXXXXXXXXXXXXXXXXXXXXXXXXXXXXXXXXXXXXXXXXXXXXXXXXXXXXXXXXXXXXXXXXXXXXXXXXXXXXXXXXXXXXXXXXXXXXXXXXXXXXXXXXXXXXXXXXXXXXXXXXXXXXXXXXXXXXXX
