XXX-?E--oB---BMXX??-EMo?E--XXEM--EXM-E--X-B-?-oXX-?M-MoMX?o?--E---B?-----BB-X-M------E-?-oEMM-XoEo-E-B-MBMEB?-B-XMBB?--?E-MMXoX-M---Mo---BooM-BBM-E--?E-M?MEE-BMoBBoMME--X------Mo--E-MM?-o-o-o--XB-MEB?
?M--BEB--?-MX-B?o-B---XXMT-EB-oo-X--M?--BM?-o-o-?M-?---B-oME-?---M--?X-M---B--?--X-X------X-M--EXo--E-MXEEEE-BX-o---M-B--BM--T?--o-o--o-?--oBXE--X-oBEX--E--BXEM-?EMMXoX--BXMo----oEEo--?EEE-?--XX?XM--B
XMBMM----MBM?X-MM-B??-MX-|E--oE-ME--MEE-MM-?-MX-Bo--EEE---E-XE-----E-XMo-----E?-o-o-EoBT-??oM-X-----M-oo--?oMX------------X?-|o-B?XoEB?--EBXM---XM-o---XBE---X--Mo--B-E--o-oX-EX-X-BoEo--B--oX-E--------
?B-E-X-------E-----M--o-M|------M---o--M-B-X----?B--o----M----BM--MB??-E-?-B-oX-?M-----|B---T--------------BX-oT-X-?-------B-|X-M--?----T----M-EM-o-o-XX?M---X--Xo-M--B-E--o---X--?---------B---Mo--E--|
--?-------XoXEo-T-------B|---X-?MoBB-oo------o--oE-M-B--X-M?ME-M--BB-----MX-X-E---XM---|-Eo-|---B---M-M-BB--E--|oE-----o---oEX-----B-B--XX------M---EXo---o--?-M--E------X-B?M--X--TX--Bo--o---?-o-----?
?-?--M----o-B---|------?-X-------B---E------B------ooMXE-----------E--E-o--M?------M---|----|??B----M----B--M-BXM---BB--oE--BoM-----o-BX-?----o-E-BM---?-o-------o-----X----B------|---------B-E---M-TB-
?----?-B-E-X-o--X?-------------?---?----E------X-------BM-M--E-o----------E---------B-------XE-----T--T--------?----?-XM?--------B-T?--M------??-o-T--M-B--X----B-------B?---------|-E-M-XB-?M-------X-X
-EX----o----oMEM-----M---M-BX-XM----E?--?-o------E--X-X------?o--?-B---E-----o----o-o--X---X-----E-|--|------------E----E-M---o-X-M|?M----E-------B|-X------o---?E?E?--B-?M-B-----X-X---MM---o-B-TEB-BXv
|-TE-o--B-B-o---oBE-BB-T-o----?ME-M--Eo--o--?--------XEM-X---B-M?-Xo?-T?----E?-oE----B------o------X--|MX--M---M-o----?-M?Eo---?TMo|?-----oMoT-E---XEE--------ET----?B--X----BB----X-T?oB-M-E--B-|-----X
?o|--M-T-E-?-o-B-B-E-ooX?----T---MB----------BE------?--MBTE-oT-----BTX-M---TM-BM-----------oM-B---E-X|----E----BEMM-----M--XEB-|--|------M-B|-E-----E-----M-oBXM--------E-BXT--B----|E-?E-B----MXo---TT
B-X--BEX-MEB--oM----?E-MoBo--|-B?--E-oB----?B-B------MX-??XMM-|XM-o?-|E--?--X--B-XM-?E?-----M-X--EEBETXM----B--o-E---E----oMB-E-|E-X-B-E---E-XM--?---BE-----------o-o--X-----|-----E-Xo---M---B-o---X-XE
X----EME---ET-M-T-B-B?MB-ME--X---T-EBB------o---------o-------|----?-|-T--Xo--------T----M-B------EMEX---o--M--?-----o--oo-----oX-------?--o?TB---X-B------T----?-T-T--M---E-|T----B--?-E------M--X-o--X
---o--M----EX---|----------o---X-|---E---------E-M-B-----T--oT|------|-|-?---------E|-----------MMoE--EM-?----M--------M--o-B-?--------------|-----------E-|---X--|-|------T-X|--o--B---?-B----o---T---B
E---------------|--M-------------|T-----------------o-X--|---|X----M-X-|?--------E--|-------M----------M-------T--------------T---To-T-------|T-T-----TT-B-|------|-|------|--|--E---------M-?T----X---?
mT--T-------T---|-----T----------||---------------TT----T|---|-----T---|--T-T---T--T|--T-------------TT------T-|--T---T-------|T--|--|T------||-|-----||---|--T---|-|-----T|--|T---T--T----T--|--T-T----
XXXXXXXXXXXXXXXXXXXXXXXXXXXXXXXXXXXXXXXXXXXXXXXXXXXXXXXXXXXXXXXXXXXXXXXXXXXXXXXXXXXXXXXXXXXXXXXXXXXXXXXXXXXXXXXXXXXXXXXXXXXXXXXXXXXXXXXXXXXXXXXXXXXXXXXXXXXXXXXXXXXXXXXXXXXXXXXXXXXXXXXXXXXXXXXXXXXXXXXX
