X-BMBEoB?--X--X--X-MBoME-BX---oEo---E?EXEE?--M--o--B-?XMoE?---o-MX-X-MB--?-o---?---?M?E-M-------o--?-?-oEM--oXE--MMo-???--Xo-----??M?--BXoB--X--B-o--X----oX-Bo-E--o----?MM?Bo-?o-M---?o--?EX--E----?E-B
|-MBoM----?o-o-X----M-MBX--BX-E?M?M--?-M--?E-MMB-M-X-oMMM-MM-?-?-B-?-MoM?--BMXMM-o-E-EE--Mo--oBE-------E--M-X--?M-E--M--?--M--B--B--Bo-o-XM?-M?-X--M--B--M?-X---XE-o-oM--M--B--?EX---?oMM--M-?o--E---M-B
M--??---M------E-M-BM-EBEXEoETM---B-E-----E-M--E--?-X---MB-?-M---M?E----?XoE?o-E-M-M-E--oB-----X--Eoo------M-E---E-------MX-MB--TXBo-Xo-X------E-BM--X-?--M-------BEo-T-TB---?B--?X-------?T?E-----T--T?
-?---B-----------?----Boo?---|B---M--?ooo----oEo-XT-B--??---X-?BX------------Mo-------E--M--XMo--M----B--EX-B-------X-------T-?E|-E-?MM-----BX---Mo----?------BE--M---|-|-?--EB-EX?o?BEEM--|?--B---|-E|o
?XE--o----?-?---M--X--------?X-o--?-?-o--E?-Bo---o|------E--??----E--X--E--???----o---XEEB----ETB---o-M-----o-?--------o----|---|---?M-?--X-oo----------o------o---?-X|X|?B--?----M--------|-B----XX-M|-
Bo-B--X--B------Xo---B-M----o--o--o-BM-MEB?--?-E--T----B-o?XB-M-EEE-E----M--E------X---------?o|B--T--B-M----T---?-o--M--XoXX--MX-----Eo-----E-B-M------?-T---M?B----B|B|EE---------Mo---XM|--XoX-M--M|B
o-----X----XX----o-EMo-----------X--Bo------X---o-|-----B--M------?--o-X-X----E-----EX-----X--B|---|-XM-----E|T-----X-M---E----B-----MT-?---oE--?M-EB-B-E-|---------o?XXX-Bo-o-M--X--M---B-XB--E?-ME--XX
M-------oB-BoX-o?-E--o-M--Eo----X--o-?------M-ME--|--o---?-------M---XM-o---?-?o-BE------X-B---|-?-TBE-----BXX|--??--E--o--TB?--B-o-B-|?--oX---E--X----E--X--o---EM---B--E------XT--XXM----o-X-------o-v
o---o--M--E--?-X?---------E---E-M-B--o?M-M-o-B-Mo-X---X----X-?---Eo--X-M-----X-E-MoM--?M------?XB?-|----E---M-|------------|--BoE-----|?---E-Eo-EXE---ME-o?---E-E----oo------???-|--?------MoB----EEEB-?
o--B---E----?--?--o-EoM---M---BM-BMX-------M-??--o-XE-M----T-o---M-?-o?----X--E-oMM--?B--E-?TX---MB|--E-MXB---|oB---E--X--?|--MB-X----XE?E-TEBEo?--M-MB-?XTo-??E---ME?B---o-o----|-BE----o--o-----M----M
--E--?-?BEE-B----B?o--oEBM-EE-?Mo---?--X--X-X--B---MEo-o--M|--B--B?------oM?-M-M-----M?--???|----B-X?--MM--o--X-Eo-BB-EBo-EXXX-?--XEBMM--X-|---M-?o--E-Eo-|X-----TMMo-B---X--?---X-----M?-MBo-M-------XE
oB-M--TT---BE------------MT-o--T-ET------?------X------T-?-X-----T------T-TT?T---?--T---T---X----------------M----M--------M---------oT---TX-------E----M-X?---M-|TT------TT-----T--X----------o------oM
B--B--||-----EE-MT------T-|----|o-|---TB---T-----------|X-T---T--|o----T|-||-|----TT|T--|T-----B--M----------T---TT-----------------XB|---|-----o----T---ET---?--X||------||-----|T-T-----B------------M
o----T||----T----|----TT|-|----|-T|---|T---|-----------|--|---|--|-----||-||-|----||||--||T---TT----------T--|---||-T---T-------T---TT|T--|-------T--|-T--|----T--||X-----||-----||T|--------T-----T---|
m----|||----|----|----|||-|----|-||---||---|-----------|--|---|--|--?--||-||-|----||||--|||---||----------|--|---||-|---|-------|---||||--|-------|--|-|--|----|--||------||-----||||--------|-----|---|
XXXXXXXXXXXXXXXXXXXXXXXXXXXXXXXXXXXXXXXXXXXXXXXXXXXXXXXXXXXXXXXXXXXXXXXXXXXXXXXXXXXXXXXXXXXXXXXXXXXXXXXXXXXXXXXXXXXXXXXXXXXXXXXXXXXXXXXXXXXXXXXXXXXXXXXXXXXXXXXXXXXXXXXXXXXXXXXXXXXXXXXXXXXXXXXXXXXXXXXX
