X?-?-??-E-?BM-E--o-XBo?-BB-MB-o-?-BXB-o-BB--MEBE-EoE?-EoXo---?o-?M-Bo----X?-o--BEM-E-X-B-E-B-M---o?o-BX-BMoX?Xo--X??X-M-X?EXE-?-XooX?E--MX?B-?B-?-?-?M---BE-M-BEBE-E-?M--BX--?E---MoX?E-?--B--BEXXM-EXXM
TX-o-?-M?EM---BoB??--EX-XE?-B---------E-oE----XX----XMX---oXX-M-o--o-----M----Mo---MX----M---E--B-?X-E----?-E-------B-oX---?--Xo--TX---BM-E-M--M-MEX--BE?-o-EBB-E-oM--B?-oBX-M-M--oM-?M-E-o--E-oM--B--BT
o-X-B---??--EBB-oX-??-EXE-o-E?E----To-----??-?-E-X-??Moo-B?EBMB-----E---MoEX--M??X-MoBoTo?--XE--?-----E--?M-E?M-?oE--X---oo-?EE-E-|M-?-M---oE-E-oMXM-Xo---?--M-E----?---B---Bo-o?M--?EMB-MBo-E-B---X-XX-
|---Xo-B--X---?---------X?----E-T--|-XBE--Mo--?ET----E-X?E--o---?---------M?-B-MTB--E-?|-----?X---------M-------MB-B--M-oME-o-?-oB|oM---Mo--------o--B-------M----M??M--EB-E-M--E---E?B---X--E---------|
?-------M--o-oB----?---o-----T-M|--|B-E---o---EX|--B-o?-BME-o------XM--X-----TBo|-oEoB-XX---E-E?------XX----M--B--E-B--?---B---E--|oM--M---------?---------T?--X---o-------E--X--------MX--------X--ET-E
E-o-----E--TEEo-----?EoM--BX-|--|-EX------B--?--X----E-----o--X-M-B-----B-EEMX--|B------E-E?-------------------o-E-M-B?--M-M-----EX-?---XB---EBB-----o--M--|----X---MB-M-?-MoB-BM?EX--?----o-MXX??---|-X
T-------M--XT-----T-o--?-XBM-XM-X-E------Mo--E-X------------?---------M------M--|?B---ooo-?-M-oE?-----o-EB-BM------Mo-M----------E?--?-X?-----o?X-X-X--X---XX-----M------E---E---o--XMB-X-EM?---B----X-o
-M--M--MMM--|---oMX---oMXM-o--------------?-----BB----X-o---o-------oB?o----E-EoXE-------o------oX-Bo---E----?--E-?----T---EEME?----M?----------E---o-X--?X-B--X--E?-------EEB-E-----o-X-o---?-------BEv
E-BM----TE--|--EE-?--o-E-E-B-o------B---o---?-MM--oEX-B-B------X-E-B--?----?-?--E-o--B--T?B----M--ME------?-M-X-TBT--T-XXXo-oB------o-T--o-M----o-BB-MB---M-------B-B----ET-o----------M----o------E----
X--M--B-|-X-X--B---?-M--o------?----?oB-??---M-------?B-------?-XM----Eo-M----M---E-MBoM|o----------B--------?E-X-X--|---Eo------M---E|B-BX---M-E---M-M--E---oE--MM-------|-o------M-B?----XT-?---X----X
?-E-?---|M--BXoo--------o--E-------M-?---EXB-EBo------?X--o?-EE--o-oX---B--EX---?B-M----X-------?M------oo---?-E-----XB??BMoE-EEM-----|-E--XX---?-----?-XM-----?----------|M-----?---M-?-E--|----------o
E-B--X--X-?----o---T-M--B-EM---B---o------M-?---M-o---T-------BoM-X?-X-XT--o----?-------M-M-X--ETMTB--?----E?-----M----T?-T--o?-----?-XM-----o--oTM---------?X-------E----XB-M---------E-MT-XB----T--oMX
|X-E--M-BB---M-----|?-----T--B-M-M-T--------M----X-T--|---T------?-TT--T|T---------------o-----B|-|--o---T-------T-----|--|o-------M-----------?-X------------B-------M-----M-----M-o----T|-B-----|o---M
ET---B---T-----T---|---T--|-----T?-|---------------|--|---|T----X--||--|||---------------------T|-|------|-------|o----|--|--T-------T-----TT--------------------------------EX-------TB-||-----M-|----X
m|-------|-----|T--|--T|--|-----|TT|-----T---------|--|---||-------||--|||-----------------TT--||-|-----T|-------|--T--|--|--|-----T-|-----||---T-T------T--T-----------T-------------|-T||-T-----|--T-M
XXXXXXXXXXXXXXXXXXXXXXXXXXXXXXXXXXXXXXXXXXXXXXXXXXXXXXXXXXXXXXXXXXXXXXXXXXXXXXXXXXXXXXXXXXXXXXXXXXXXXXXXXXXXXXXXXXXXXXXXXXXXXXXXXXXXXXXXXXXXXXXXXXXXXXXXXXXXXXXXXXXXXXXXXXXXXXXXXXXXXXXXXXXXXXXXXXXXXXXX
