M--XX?B--??--?M---o??EBEMX-XB--X-MX-EBXo?BoXEX-?XBB-BMXXB?-M?--?--BM-MoX?-B-EE-XM?E---o--Xo-TEE--oEM----------o?XB?-?Xo---X-XE-oBXM-??M-B?-XB-E?MMMoEBB-E-MXEXM?oEEB?oE-oM---B?--MB-?MEXEXoMM-M--E--ooM?
---?X--MMoM-----BM-B--o---o?-oX-XEMoEBME-X?--M--E---M--X---?MX---o-Mo--E-oX-MB-X-MXM?--oEMo-|--o-o-??BXX-XB?X-?X--oM-??B------XBo-BMMoM--o?o?B-MM-o--MMM-???-XoEM?E---E--Xo-?-??o?--?M-MEMMooB--E--M--XX
?-T-?-M--E--X-o-B--E-B-E--ToBMX?E-o?XB-E---T-oE-----E-BMEE-E-oE-TBEM--B--??oM?--??M--Mo--M-E|?---o-X--XE-?BEM-??-E---E--M-X-M-XoEX---??oM---E-XX--ToE---?MB-?-MM--B-M?B?--MXXX-M-o?----E----oM--M?-----X
-X|-----------BM---E-B--oB|-E-?------------|-E-----MMM--oo-E-E?B|----?--Eo-----?--B-MX-B-?-B|--------T-?-E-----X---M-Mo--M--X----o--X------T--E--M|-o----B---M-------X-----X?M----M-M-BE------M-X--M---o
o-|--BB-----o-E---Bo--T?-EXB--E---BX--X---X|-M----------T-E-BB-BX----oM?-E--X--B-E---T---M--X-BToXo--|----?---E-BB-E--E-M---E----o---X-----|M-----XE-M-E--X--oBM-Eo?---B-E--?--T-X-----M--E---B-o--E---X
o?-XETB----M---------MX-M------M---?---?---|----BoEB--?-X--E---BM-------B------------|T-o-E-?E-X---?XX-M-o--M?---ooM------TBMM-------Bo---T|-------T----o-?----?-o---E---o-o---X-o-M--o-Eo-------T--o-MM
oBXE-XM-MX---?-T-------------?-----B---MEo-X---?MBo---oM-EBB----B--------------?-o--E||--Mo--M----Xo-Mo-ME------X-B-B-M-E-T---BX--o-o-?--XXX-------X-B--o-----Eo----B-?-XB---?-------M-?--------X|Mo-X-E
|MM-B-EX?--?---|--E------o--X-E?--E------E--B--------X-E----M-T--B--o-?------oB-o----|X---B?-B?-X------?-?-------MoX---X--X----Eo--------B----?--o---BM---?-o----M--E------?o-E-?---B--BBo-?-----|---Bov
|----E----o-?--X----M-?-XMB-?----E----M--o----E-EoEB--o--X-o--|---BB---------B-------X--MM-B--------X-----BoX--T-----E-o-?--------------B--------E-X-?--------E------Bo--X---o-o--?X?-------?----XB---?E
-----BM----M----oToo-XoX-----M---M-MMT---------X--Eo?----B--X-|--------------BMX-B----------E---B-oBM-----?----|--B-----BB---oB-o----BBM-B--?oX-------M--E-M---------oo---T----o--------?X?---?-o--E---E
-E------??-M-----Xo-----M-X--?X?E-B-o|--M-oo-X--M-?--?BX-TB-B-X-E--?--E----X--M---o-B---M-?-----M---E-B----B---TBB-B-?M-M?-?------?-------o---EXBo----?X-E--BXXEMoM----ooMX-X-?-BXEE--?-----XX?Xo-E-XE-X
B----M-?E--oXM-E-----B-M-T--E----E---|-----T-E-T-----B--M|-B-M-T--X--o-E-E-M-------M--?-oT----o--------X?ToTXE-|--B-------------??-----?-X-M---oB----XB?XB--E--------Bo-B--?--M-------?---B--T---?--o--M
T--B-------------E------T|---MX---M--TB---?|--T|---T-M-B-|-----|-------T---?-------?-BTM-|-----o--------?X-|---X--B-------------M-----B---M?----M-----------BTT-?--?--T-E---------TBT--M-?---|---------B
E-----E-M-M---------T---||TTT-o---T--|---o-|--||---|-M---X-TT--|----o--|---------T-T--|--X-----T----T-T--T-|-T---T------------T------------T----TT-----T-----||-TTBB--|T---T------|-X--------|-----T-TTB
m----T--------------|T--|||||-----|--|-----|--||---|T------||--|-TT----|------T--|-|--|----TT--|----|-|--|-|-|T--|------------|------------|----||-----|-----||-||----||---|--T--T|T-T-T-T---|-----|-||T
XXXXXXXXXXXXXXXXXXXXXXXXXXXXXXXXXXXXXXXXXXXXXXXXXXXXXXXXXXXXXXXXXXXXXXXXXXXXXXXXXXXXXXXXXXXXXXXXXXXXXXXXXXXXXXXXXXXXXXXXXXXXXXXXXXXXXXXXXXXXXXXXXXXXXXXXXXXXXXXXXXXXXXXXXXXXXXXXXXXXXXXXXXXXXXXXXXXXXXXX
