o-oB-BoM--EEMX-X--MX-X-MB-oXBBXBMBXXM--M----?M-?B-EEEBEBE?--B-B---MM-oM-?E-E--ME-E--?EBMX--oM--X--?XE-EM---BEoMB---??-oB--?Xo?Mo-M-E?-M---o---B--MXE?o-M-?o-?XB-EEXMo--BB-E-MXM?-?B?-??-?-MEX?B-M-E---E-
M-M-o?XX-Eo-XX-M-ME--E?oX---M-EBBE-M-----EE-B--E-E---EXo-MEXBEX---E-oXMoM--XBM---MoB--?-M?--BMBXM-B?---?EXE-?B---o-oBo-B--X-MEEME?-?----MM-XX-E-oBMo-?--M-EE?MB--EB------o-B----BB-X-?X--B--E---XBB?X---
-BBX?-B-o-XoMXXMX---X--M--o-E--BoXBo--oXo-X-EM-X?Mo-EBE--M-----?-EBE--B-o-??oEX-o?E?--E--BB--MoX----?-oMBoX-o----MB--X-----?--o-?--M----B--B?EXBBME-BB--B-o-X--oX-B?X?-X--BB----E???-?EB--E-B--M-ooMMo-o
X?Mo--E-MX--BXXM-B--oBoB--M--M--?MB??B--E-BoB--o--E??oXE---XM?--BEo?--oE---B---BBBMoBBo?E-?-o--o??X-----M-?----X-?--o-XXE--M-EEM---MX-X--E?XXB-oEB-o-BEXE-Bo-EEo--?--?---XE--EEM-M-XBM-oM?-MoMM---X--oME
---MMMX-ooM?M-o-MM-EX-BB---E?XXME-E--X?BXBoX-EM?-BXoo--o--XE--?o--X-?--?-------E--EMo-E-oM-oMXX-?-??--M----B-M-MXo-X?M?XMB-?--o---E-B?EBE-X?BE-oo-B-B-EEXB-?-BMMM?ME-MMEoX--M-BB?BBMBX-MMMM?M?-Xo----MXM
M?X-XBo-X-MM-M-B-?EM-?BBEoo--oo-MB---EB-MoME------oE-?M---?B-o-MoM-oo-----EoE---o-X--XM-XXEB---????-Xo-X--o?-BX-E--E?-?MMX-E-?ME-EMXooEE-BB---EXEo-?X-MEM-B-BE---?EMo-?EBX-M?oE?-MM?----o-X-??E??--XooMB
X-----X-?-M--XM-Bo?ooo-?XE-X---XBE?-XB-?--XM-B--?BB--o-o-??E?o-oo--EX--?o-oMM--X-??--MB??Mo-MB?----XoBX-X-M?E-Eo---oX--XooEo--o-oBM--BXXXX--ooMXXB-?MB-X-??--o---B-XM--?-o----oX?MoX-XB-MXE-??-?B-XEMoME
E-XoBEMB?B-X?B-B---???B-??E------X--EBEE-E-EE----?E--XM?oX?-B-EEBXBE-XoE-o-EM--MMBX?---oB-o?oX??--?-XX---M?oB?M-?Xo-BooM-??---B-MM-M?---B-oM?B--X----X-M-X?-o-BB--o-?B-XoX-XM?oE-oBo---o-?--E-E?XB--EXMv
BBo-o-oB-oEE-M--B?EB-E?E---E?o---??-BE-B-?o--XX---BE------o-oE-XoXMo--------?-M---X-Xo-----X-EE-o?EBE-E---B---o-M?BMo?M-o?XX--oE-M-Mo----B-XX-o--?MoXB-?XXoooo-XXoooXXXBE-E-MEE??BB-B-E-?-?---?EMB-MoB-B
XB---BEBXEE--EBo?-BM--oX-MM-M---oEEB-B-M-BE--B?M----o-MM?-E-EM-BBB-M---oooE--?XE-Eo---E?--?BB?-M-MB---EX--XB?o-M-E-X----B-?MBo-XoXXMXoMB?oM-EEXMo-B-X-BE---E?-BoEB-?MXo??Eo-oB-o-MoM-Eo?Mo--M--?---?B--?
X-MMo-EEoE-E-E-ME--MM?---oEB-Bo--E-o--MB?-MoEMBo-BX-o--Eo--MXXoM-XEo?BoM-XMXM-----oM--B--M-M-XoMo?------X--?X?-E-E-EE-B-oBE-?---o?-MEE--oo---?-MXX?o-M??MEB-M-XE-Mo?---oo--X---o-?MB-B--E-B-XM-?Xo?-M-E-
o-MB-M?o-B?EB-M-BB--Eo?MXX-oX?M-EBB--oB-?X-E-BoXBMo--XX?oo--oM--EBMBXMXoEXBE---E---M-?-oBoo?X--o-----M??-XoEo-BXXMBMEo--o----EMB?B?o-M---E-BE---X-o?Bo-X-E-M---X?-B-XX-?-E-?EX-B-X?oE-MBM-EM--XMM----X-o
EXoo?-oXMo--X?--?-EXXXME-X---?-BoM--MB?---E-MBo-B-MB--B?o-XX-?BX?-X-X-EM?E--MBMEB-oBEMoMXo----EXB--oEX--MBE----B?--?--?BE-M--B??M-?-Bo-M--XX---Boo?XX?---?XX--BMXo---ME?EM-??oM--EM?EBB?XX-EXMB--M--EMEM
?--XX---B?-X-E-ME-B-?oB-XB-XB?----X?-M--X-?--?M-oX-o-?-B----EX---?MEXBE-oE-oXMB-?X?B-B?EMMM--EBEMM-X-?X-X-?-o?--oXX-XB-E--oBE-o-BEE-X-XMX-----Xo?B---M-EB-?MX-BE-M--??oMM-EB-EB----??E-B-ME-o-XooM--E-?o
m---ooXEM-M-Xoo--BE-B-E-X-MEMB-X---M-X-B-o?-MB--Mo-oo--EBXBXX?M-oB?----XE?E---?M----BEMBo-M-XEEEX-?o-EXXoEoMoEME-?--oMX?XBX-X---EM------BXXoXBX-?M--B--?--X-M-X-?BEo??oMMXE-?-B?-?-X-o--X---Bo?o---XME-o
XXXXXXXXXXXXXXXXXXXXXXXXXXXXXXXXXXXXXXXXXXXXXXXXXXXXXXXXXXXXXXXXXXXXXXXXXXXXXXXXXXXXXXXXXXXXXXXXXXXXXXXXXXXXXXXXXXXXXXXXXXXXXXXXXXXXXXXXXXXXXXXXXXXXXXXXXXXXXXXXXXXXXXXXXXXXXXXXXXXXXXXXXXXXXXXXXXXXXXXX
