ToXMo-oE-ooX-?-o?M--BX--X-oXMX--X?o-??---E-BX-XoE-X??oMoM?X-X---E?-?----EXEXo-o--M-oE-----XE-oE-EoXMXXBM-?----?E-EBE?--Boo---X--M-oB--MB-E?---X------MB-BE?X--EMM-MME-?---B---MEE-E---o--?Mo-BEEEBEB--XX
---E-M--M-?o-oX-ME-oX-?----?-EX-X---EoX-EB--XEEEM----MB?-M-oE--EX--B--BM------o-----?-B--B-?---Mo--o-B-MBMM--EE-X-?-M---EEo----E--oBM-oEX?--Xo-X??-X-B-oX-o-MM----X---X-?EB-?-MB-XoM?--B-B---B----X-?EBT
|----o--E-XoX-MB-E-T--X-?-?------BX--T-B----?-E---M----E---E?-oX---------E--BM--X--Mo-M----------o-BM-X?-?-M--?M?B--E--BoX----X--EX?--M--EXBMM-o-X?-o--o--?B--M-XB-XX-----XBE-E-B-EM-EMTo-Eo-XT--o?XEX?-
M----T-MXEo--?X--B-|-?X---oE----M----|X---Mo?M-----BT?-E---E-----o--M----o---X-M-M-M---?-o-Mo----?-BM-M-o-M--?---M--oo-T?---?MMMM-E-M---------o--o---X---M---------------B----------M--|-X-oB-|T-M-o--ET
T--EoXM-------?--B-|--M--------E-E-o-X-T-----?--E---X--B---BEXE--M-MB----------T--B-------------M-----?----T----o--Eo--|-----B--E---o------?-BT--?oBo---?------X--------TMB-------T----X------X|-------X
E-BEBM-------o----o|T--B--?-?-----E-o--|-oo---o-B--M---MTE-o----------?---B----X-E------?--o-E-TEB---XE----X-----------|----------------BX---B|--?---o-------------ME---X?o-------X?-----?-?EE-X------EX
oX---M----MEX-?-B--X|------------B-?-EBX-B-X-B--E------EX--M--o-T-----E--T-M----T-B-------X--M-|?M-----oo--?-E---B---M-X----?B----X--B-----?--X----E--X-?--E---MT-E-M---oMM-------?-o--o--?--M--T-----MB
?oT---M-X--EE----oB-X----E-----TB-o----?M-T---M--?--------------|---B--M-X--Eo--|-??---------?-X----B------o---------B----?--?o?-?-----?--X-E------E---M?-------X-BT----?----X--M-------?--Eo-?-X-B-M-Bv
M-X?--MB----B?-oB--------o-----XBo-?o?----|--?----------?---B--TX-------?EE-----|X----EM--?------B-??-E----o---T-------oE---X---------X------o--B---M--------M---E-|BB----E----------E----?--T?--M----B|
M-B------M-T---o--M-M--X-E-EB-----?-------|----o----M--Bo----X-|-----M?oM--M----X-------M------X-E--E-?M---E--M|--?-X------E---EE-M-X?B----M--------o---B---B-XM---XB---?E-X-B----E?--?--?---X-?-------o
TM?M--E----XB-----o------E------B-M---oB--XX---------X--BMEE---|------E-MX-------XT--Mo-BE-?-M-M-----M-oE-E?---|---XB-BE---Eo?-?--EX-----o--------XEE---?----M--E---B-o--B----XoMT---------M--X---Eo---B
X-T-T--T---?---------?-MTB-X-----------------------X-----------|E----T------B--?--X-T-----------M--T----oXo----X--T---------M---------TB----o---------T-o---------B-----?--B--M--X---TB?B------B---M---M
B-|-|T-|--------M--T-o--|------------B-E---------T-----T------TX--?--|--------------|---------o--T-|T---B--T------X-T------------T----|---------------|---------------?-T---------M-E|---o--?--o-T-----?
M-|-||-|--T-----T--|T---|TT--T-----T--TT---------|-T-T-|----T-|T-T--T|T--T--T-----T-|-----T------|-||T-----|---T----|T-----------|--T-|-TT-T--------T-|T--TT---T----T---|T---T-TT----|----T----T-|-----E
mT|T||-|-T|---T-|--||T--|||--|-T---|-T||T--TT--T-|-|T|T|TT--|-||T|--|||--|--|-T-T-|-|--T--|-T---T|-|||---T-|TT-|-T--||--T--T--T--|-T|T|-||T|T-TT---T|T||--||-T-|T-T-|-T-||TTT|-||-T-T|TT-T|--TT|T|-----?
XXXXXXXXXXXXXXXXXXXXXXXXXXXXXXXXXXXXXXXXXXXXXXXXXXXXXXXXXXXXXXXXXXXXXXXXXXXXXXXXXXXXXXXXXXXXXXXXXXXXXXXXXXXXXXXXXXXXXXXXXXXXXXXXXXXXXXXXXXXXXXXXXXXXXXXXXXXXXXXXXXXXXXXXXXXXXXXXXXXXXXXXXXXXXXXXXXXXXXXX
