o-M-oo?o--o?MMX-?o--X-MXX-E-B?-o----?--M-B-X-BB?-?----M?XEMMooMX--E?ME---XBBMBX-oM---?-X-B-?BM-M-M?B---o-MEo-B--oM-XEME--MoM--XoMBXMoXMX?----B--BM?XB-MoE?---EM--?--B?E-BE-M-EM-M----?BMBMEo-o-B-XMT-???
---oM--E?--BMBM-M--BX----?ooE-?--BM--MoEE-X?MM?o--X--B---X--?-MEXE-?-X-M-X-oX--MM?BB-Mo---B-XoBMB-MBXoB-X--o-MX?M-BB-M-TB-oXBXEXX?oX--EXEXoM-Bo-??M--?oB-M-o-M--EMo?X-----MMXMM?B?M--?X--B-BM--EE--|M?B|
TMBB?----?---M--EoBBE--?--o--o?-oB-Mo-o----X--o??MX-oE?-Eo---??M--Eo---XBEB---B--oM---------EM-BooM?XME--BoXTEo----T---|B--B-BEE---Xooo?--MBM-o--X--X?-?-?M-o?-------oM-X-X--M-??--EXo---E?o--BM?X-|E-M|
T-o-B-T-X---T----B---M--M---o---M?-M---M-?M----?-XX-EM?--?-MX--??---------M-----B--MM-Mo---?--B--MX-XEM-o---|---?--|-X-|----X-?B-X?o------?o--o--E----E--o--------E-?--------o--B----EBX--XM-?-o?--|----
B----EX-----|----B--??-----B--o-M-o--T-------o--X----E?--oE--BME-BE-------B--XooE-B?----E-?--------E--------X---o--|E--XBBoX-X-E-----B------?B----M---oM-----?--------BEE-oMBo--?--MX-B-o---Xo-----X-B-o
T---o-----T-|---?---?------E---E-----|?o-------??-o-T---o---?-?-B-M----X--M---------E-X-o-M----E---o-E--?o-----?M--|----o---?-Eo------MEX---oT----?-o--BE-----?-----------M---------oE?--oEo------?----|
BX---?Mo--|-X-E-------o----??Bo------|--T--Mo--Bo--X|--------------o--ME--B--oE-------B?------------M-o-------E?o--X-XX-----o?---E?X------B--|--MM--BM--M--?--BX-?-XE----?-?---oB---M-----Bo---------EBB
B--B-----MXX--?--?-------?X------?--MX-MX-----X-----XE----o-E-----E--o--M----B?--?M-BB--?-B-E-----------B-?-----E--?-E---?---BX-M--E--E-?----XE--BB------M---o-E----?E-X--X---X--B--o-E--oE------X--oo-v
|-B-X---X-----?-T--E--X------XM--?---?-----Xo-B-XM?oBME-X--o------E--MEXBX---------X--?X--BM--------XX----?----?-TEE--EM-E-E--B-o----?----M--oT-X-E-T----oX-EBTE---X-EE-MX--?-----------X-?-----------?T
--------E--XE-B-|-X-----?-o---E-B---M--M----?-oo-oM-----?XX---------o-----E--X--?-----o--X--X----Mo-B---M---MB-MMXM-?----?M--M---Eo-B--?------X---M-|E?X---M-M|M--Too-BXB-?---X--oM-------Mo-E-----?o?EX
B-X--E---M----M-X--BE?B?MM--B--oB------o-EXM-?-o----E----M-E-E--??M------X--oE------X--B--o------M-o-M--?-o----MM-E----E----------oM-T--EoE-TM--?--M|-?BM?---EX?--|?M--MT-E?B---X----M-X-----o?--?B--B?B
T-B---X--T-XTT-M-?------B--TT-----?---M-T-M----?-T-E-?---T--------MM-B-----o--X-----BE--o-----B--?T---BT--E---B------M-----TTB----EE-|-Eo--?XM--E---X-------?----M|?-TM-|---B-TME--M-T-EE-E-------TE--T|
T-T------|--||------------?||-----------|B-o-----|-o-----|-oX-------E-----X--------X-----E--X-----|---E|-------------------||BXT-----X-oM--B----------------o---X-|E-|--X-EM-B|T----T|--oEo-------|-oo|T
X-|------|--||-M---T--?--?-||--T----TE--|----?---|-T---T-|-----MT------T---T------B--B-----T------|----X----------B--------||--X--M--T--T-o---------------T-----B-X?T|B-TT----||----||------T-----|-T-||
m-|------|--||-----|----T-T||--|----|---|--T-T-T-|-|TT-|-|-T----|------|---|-T------T--T---|------|T--T---T-T-------------T||---T----|--|-------T------T--|--T------||--||T---||----||------|--T-T|-|-|T
XXXXXXXXXXXXXXXXXXXXXXXXXXXXXXXXXXXXXXXXXXXXXXXXXXXXXXXXXXXXXXXXXXXXXXXXXXXXXXXXXXXXXXXXXXXXXXXXXXXXXXXXXXXXXXXXXXXXXXXXXXXXXXXXXXXXXXXXXXXXXXXXXXXXXXXXXXXXXXXXXXXXXXXXXXXXXXXXXXXXXXXXXXXXXXXXXXXXXXXX
