---?--o-M?---?-E-oB-E-o-----?-M-M-BE-M?EEXXoBM-XMXBEo-o-XM-XXME---oo-------XME-o-BBoT-MX-MEoE?M---o--?o-?B--?ooEX-EM?---?oX-o---?EMEXX-?-------?----XB-X-XXB--XoXB--X?-MBoE?--M-o-M-----B-ME-oMo-oM-EoEE
X--XE--MX-MMo-M-----E-T--o-MMBXBE-?EoMB-BMMX-oB?M?M-MoM-----ooEB---E-E----XB?--M--M-|X-X?B-B-o?-M---XB?MMo?M?-MX-BEEE-o--?---o-oEXoB-??oE---------o-EB--M-M-X-B?-oM-----XEB-B?BX---M-M--o---o-BBo--oE--B
---MB--M--B---?--M?-EM|MM?---XMX--oBXM-B?-Xo?E-M?---M-BM---MM---M-E?B?X-M-BEM?-EE--M|BMM-T?-E----BB?o-X-E--X?o---B?XMX-?X----EM--E??-M-X---oXE???ooXME-?-X---BX-E-M-o----Mo------M-B-?B--M---ooo-B--E-BM
?----X----M----TE?--E-|-?------M--MB---?-B--B--------------oo-M----X----E--T----X-?E|--X-|---X----TX----M-T--MX-oM-M--T--X-?X----E--?---TM---?--o-T------o---M----MMo-o---M------X-------Xo----------oXM
-BBBE--o--?---?|-----E|------MB-EX-BB--?--E-?--M--EM-B--?MX-o--?-----------|-oX-----X---oX-X------|----B-M|-----BB--M-|EM---M---Xo-----B|BX---Bo---o-M--B------?---BM----E------M-o-T?-X---X-B-EM-B----?
??---B--MX-XBEBX-X----XE---EX?-T----B----X--?o---o--M--------M-B--o---B---oX-----M-M---------?-M--X-o---M-X-----o--?--|------B-?---EE--?X-B---B--XX-------E---?o--X-------?M---M-BB-|Eoo---B-M-?--oX-X-B
E-------E--B----M-ME--?MM-o--?-|---------?X--EM-BB--o-?------?--------------------?Mo---?-------M-----Xo---o--o-------|-M--X-M---EBo-----B--oo-X--?---M---M--E--o---EX-?X-M-XoMM?--?|-o?--E----?-M----BT
B---MMBB-----B------------B---X|--X----E----XB-----------E---o---------M-?---BMM?------o-?E-B-EM------EE--X-o--E-?---EX-E---------------EM-E-?X---E-XB-?-------oo-----M-----oB-o-B--X-EM---------oMX-o-v
B?--?--M----E--M--?----B-ME----X------B------BM-M--o------X---M---T--XE-------B---o---M?-o-----------B----B--B----E--o-?----XoM------B--o-ME--?-M-ET????--M---X----o-----E---?-o--B-E-----?XE---E-M----T
---M---B------?-------o-?EB?E-Bo-MXXX-B----X---o----oo-----------B|B-o---X-M-o-E-----E--M---------X?-----B-------B--X---B----------?-M-?------M-?-E|M-?-o-T---E------o-M-----o---------Eo--B---o---M---E
oXoB--??------B?-EE-E--?ME--o-M--o---E-X----?-----B----X-EBBMX-o-?X-M-E-----------o---o-o--oEo--X-MMo-B-?M-?--E--------E-?-M--X?----M-M--M-Bo--M-?-|---?--|--oM---B-BE--BM-M--B-------o?--o-?------B--Xo
M-o---B-----T?-E--E--------oM----??--T--?E-----T----X-XT-o----T-?-B--X----------B------B-X--?---T-MT---?------?-?----?--T---E--M--B------M---------XBB--B-XE--T--------X-?-TE--?-M---X-o--o-?B-oB-T---EX
?-EM----E-X-X----------o-oM-E---T---T|--------?|-X-----|--M---|-------o-?-E-----o-TM--------M---|--X-M-?-------T-T---TM-|-E---E-XT-E---T-----M---------?------|-T--M-------|--XB-------M-M---B----|-?--B
---------------T--T----T-----E--|---||---o---B-|--B----|------|--T----------------|------------T|---------X--X-|-|---|--|-B------|-----|MT------T----------X--|-|?----T----XT--------------E---T--|---T?
m--------T-----|--|T---|--------|---||--------T|-------|----T-|--|--T---------TT--|T-----------||---T-------T--|-|---|--|----T--T|----T|-|------|--T------TT--|-|-----|-----|-T-----T-----T-T--|T-|---|o
XXXXXXXXXXXXXXXXXXXXXXXXXXXXXXXXXXXXXXXXXXXXXXXXXXXXXXXXXXXXXXXXXXXXXXXXXXXXXXXXXXXXXXXXXXXXXXXXXXXXXXXXXXXXXXXXXXXXXXXXXXXXXXXXXXXXXXXXXXXXXXXXXXXXXXXXXXXXXXXXXXXXXXXXXXXXXXXXXXXXXXXXXXXXXXXXXXXXXXXX
