-o----XB-BEMMM-o---B?-B---o--M---E--M---EM-M?BB-?--?-BE-----?o?X--?-XXB---MEoB--BE?--M-XEoBB--?BE---X-?-TME-EX---X-o-Xo?-X-o--B----oB---oB?o--EMB--?M-E--XM?---X--M---Mo-BM?-X-MB-?BBBEo?-oo-MXEB??---XM
-o-M-o--XE--oE-BE---X-MM---M-EX?-oX--MXX-BMXXo--?MM-B-M---Xo-Eoo?o---Xo-o--MM--oE--MB--o-------X-BX---EX|-----BB-oMMB?--o-?--X-o?-BXM--M---oo-------XXBo-EBX-E-?-X-M-?B-E--E--M-EB?----EEEo-?oXB?-MXE-MT
TBBBMX--oEE--XX-??oB-X---BoE-EMEE-BMo---???--EB?o-o-MoBEX-----XX-M?--E--Eo--X---?--M---M----MXE?-oBE-X-B|M-Mo-E?T-o----M---??o-EM---BX-E--o-ME---XMo-XoBB-Xo--Xo--B---X-o----Eo-MEo-?----B-oX?Eo-Xo---E-
B-?---B?-E---M--o-----?-------?X-EM---XE------?-B-B----o--?-o?-------E?o--M---------X-----------X--oEB--|---X--X|---o---?----o-o------XM--XB----X--X--o-oX----XX--------M--E--X----B-?-?-?Eo-B---------?
XX--o--B-E---o--------B--X--?MM-------?--o--T---?--MB-Eo----E-MB-T-M-E-TT-M-?-oM--X---X?-XEE-B-BMo---B--XB------XB--EXE-BMEB-?---T--?--B---o--M---E------MoXE----Mo-X-XETBX--M---------B--------??--E?Mo
X-E--------M--------o?--Bo--T-?-?X--BB-B-M--|--?-E-o--?E----M-oE-XMB---X|-T-------B----M-Mo?------B---B--M-BB?M---?------E---MX--X-?----B---BX---o-M-B-M-EM-----E-E-E-E-|-------?--?---?E--??-----X??--E
E-------T-B-T-o----------o?-X----EoMB-------|---X------B---XM-EB----?-?-|-|E-M---T-----B-----X---?---M?B--B---o---------To-XX-M--o----B---XM-E?oTM--X-o-B?M-MXE---------X--BM-?o-E-----o-----oo--------o
T-X-E--MX-oE|-M------o-E---M--X--M-----o-?--XXM--M--XXEoXT-?E-o--X---o--X?X----?X|-----MMo------E--o--------B---?-----B-X--M??-----M-oo---?---o-|-oB---E?--------X--E---?---M-o?--B-------EB?M---B----?v
-o-o-X-----E|?--BX---BM-X---M----oM--o-?Eo-----Eo---M----|--E---B-------?--?--o--XE-----------E-B--?XM----ME---B?-o-E-o----M---?M-----BE--?-----XBMM--X-------T-E--X---B-M-E----E----?------BEXE-E--E--|
X?-B?E-?----|-oTM--??--Mo---BX?--?---M-M--oB--B-M--B--E--XX-M--X---oE?o---BM--?--T-----?----M---------------oM---MM-M---------E?--BX--Eoo-----Xo-Eo------?-B--X------?-E--B-EB--E-B--?-E-XX---B?-B---M-T
o-M---X-T---XM-|-X-----E--X-MEB-X---X-o----?-M------------oo?-o?-?---o???M-MBMM--|B----o-----------T-E---X---B-----X-?------M--?-?--?--o---M-----o----Mo-----?---oo-M-oMoX------------X----oM------M---M
T------X|?-----XX-X-------o--T--B----E-?X---T--------?-----M--E-M----o-MME--E----XMX--o--T---?-----|--XB--T--MTM-?---o--E-------M-B------?T-E-X-TB-M--?-----------B----T-B---------?---XXT---?---M---B-X
M--oB---X?--M----------------|-----TE-------|--M----T-X-------T-o--------o----M-TM--o-T--|-X?------X----o-|--M|o-----o-T--------EMM--E-B-E|-----XE-T-------EB-------?--|-E---T-------oo--|-----------MT|
X?---------------ETB----M---o|-B---X--------X-----X-|-------X-|--T--------------|---T-|--|-TB-------T-----|---|--?-----|T-----XT--o-------|-----B--|--T----T--B------T-|----T|-----T-----|--T----T-T--|B
m----T------T-----|----------|---------------T--T--T|--T---T--|--|--------------|---|-|--|-|--------|--TT-|---|--------||----T-|----T-----|---T-T-T|--|--T-|---------|-|----||-----|-----|--|----|-|--|E
XXXXXXXXXXXXXXXXXXXXXXXXXXXXXXXXXXXXXXXXXXXXXXXXXXXXXXXXXXXXXXXXXXXXXXXXXXXXXXXXXXXXXXXXXXXXXXXXXXXXXXXXXXXXXXXXXXXXXXXXXXXXXXXXXXXXXXXXXXXXXXXXXXXXXXXXXXXXXXXXXXXXXXXXXXXXXXXXXXXXXXXXXXXXXXXXXXXXXXXX
