-------o---------------------X?---------------------o------------------------------------------?----------E----------------B----o-------------------------------------------M----------------------X----
---------?-------------E-------------------------E------------------------B------------------------------?------------------X---------------------------------------------------------------------------
------------X--o-------------M---------------------M--------------------------------------------------------------------X----------------------------E---E----------------------------------------------
--------------------------------------X------------?-----?-------------------------------------------------B------------------------------------------------------------------------------B-------------
------------E----o-------------------------E---------------------------------------------------------------------B------------------------------------------------------E-------o?----------------------
--------------------------------------o-----------------B----?-------------------------------------------------------------------------------------------------?-------------------B------E-------T-----
----------------X-------------------------------------------------------------------------T-o----?--------B---------------------------X-----------------------------------------------------------|-----
---------------------------o--------------------------------------------------------------X------------------------------------------E------------------------?-----------------------------------|----v
----------------M-T----------------------------------------------M---------?--------------------------X---------------------------------------------------?---------------------------------------X----f
------o-----------|-------------------------------------XX----B--------X------------B------------------B--------------------E---------------------------------?--------X-------------------------------f
--------M---------|--X---------------------M-------------------------------?-----------------------------------------------------------------------------B------o---------E-------------------B--------f
---------X----o---|------------------------------------T-------------E--------E-X------------B-------------------------------------------------Eo----------------------------------oX------------------f
---------?--------X------------------------------------X------E------------------?---------------------------------------------------------------?-----------------------BM----------------E-----------f
-------------------X-------------------B----------------------------------------------------------------------------o-----M----------------------------------------------------------------------------f
m-o--X------------XB---------------------------------------------------------------X--XX-XX----XB-------------B----------------X-------X---------------?-----------oX-----------------X----------------f
XXXXXXXXXXXXXXXXXXXXXXXXXXXXXXXXXXXXXXXXXXXXXXXXXXXXXXXXXXXXXXXXXXXXXXXXXXXXXXXXXXXXXXXXXXXXXXXXXXXXXXXXXXXXXXXXXXXXXXXXXXXXXXXXXXXXXXXXXXXXXXXXXXXXXXXXXXXXXXXXXXXXXXXXXXXXXXXXXXXXXXXXXXXXXXXXXXXXXXXX
