-B--EXoX-B---BM-MoM-BX-BXB?B--Eoo?oo?-EE-B-oMX---o-BX---??E?o--E-------o--M?-oB-?-EoMEoM-EBE-BX-M-B--X------M---?E-----E--?--EMX-BB?MX-BXEoX-?XM-?X---B?-EM-?-XMXo---B-M--?-BM?E--MXXM-MEBEM-Eo-MMX--?Mo
TBEMXoEMo----MXo--MoEEB-BX-?XEX-B--o?B-?ME-E-B?-----BE-EEMM--o--BME-o--EE?-X----M?M---?----oX-o?oo-E-o-X?MX-M---BEEE--BX-MMME-MXoMo-oB?--M--X-B-ooXEEEM-BE??--?EX----E------BXX-MBM?----BM-M-?MEX--X?M-?
|--XoE-BX-??ME???B-M-M-----BoX?X--BXM---o---M?XE--X--E--X?--B--------E?-?--?B--B-E-B-E--o--E-M--XoXE----M-?---?-EEXoo?-o-----?X--B-o-o?E-MooBE-oM---E-EEB?---?-E?---------?B?MXE----o-Xo-BoX----o?M---oo
--?--M---MMX-E-o-E--ME---E-----B--?-B--B----B---oE--X-----E-MX-oM--o---X-E-E--?--o--B--o?--M-?-----BB--MBB-ME------?B-B-----------X---oE--o-B-o---------M----o?-E---TE-o-B--EEB--M---B----------B--o?--B
BE-XX---oE-Bo?B-----------oEM-------EBB------o?----E--------E--M-XB-BMBE-o--------M-----E--?o---?--M----M?-M--M-EB----M-X-M--XX?---oMM---B-ME--?M------o-----?-----?X---------M----EoBM-oB--BM-M-?E---Bo
|--E--Mo--XEM---BE-o---M?M-M--?-X-?-----------?-----o-B-oMoM-X--o?--M-BB--B-?----------X-E-B---B?---o?---M--B-?XMo-------E-----ME--o?----E--------------M-EXE-----X--X----o-?o-?-o--E?-B---o--------X-EB
EX--B--M?M-Mo---?---M-----M----o-Bo------?----E-B-XM--?E-o-EB-X----?o--?--------B---?----M-M--?-M--BEE?---o-Bo--o--o----M-?-------B-M-X---MM---o---B-?-X----EMX---EB-----BEB--o------M--?B--X-----E----M
BM---B--E-o----MB--E---XMMo-XM-M-M----Bo-----o---?o-EE--EB----E-----??-----B-XX--Xo-------M-M-BM---Eo--T-----M-?EX-EM---?-?M-E-----------E-M---M------M-M-M-MoBB----o---E-E-MMoB?----EX------M-XM---?X-v
E----M--?----EM-MXo---------E----o------------M-o----M-----E----M-E--B--XX-oX-------o----M----BE---EEB-X-?B-oB-?-M----MBE---XE------E----B---BXB------?--o-Xo-M-XE--------o-------XoE-E----------BM--o-o
o?--?---------------X?BB-BE?----------B--------B--------------B--E-E-------BB-M--o---?-?------BB--B---X--?--BMMB--?EEEM----M-EM-----------o-------E--------B----o-----------o-X----?----------BBB-o----o
E----MB--X-------?o-E--M-EEE--B---ooM------oE---B--M-------------------o--XB-X-M-?--o-------X---X----B-----XMMME-X---?--BM---oE---B-XEB-----o------X-------oXBM-M-X-o--oo------E?M--X---o---B-o--M---?-?
E--E-o-oM---B-?BMT-X-X-M--EBo--E-B??-o-M-E----T--X-oBM-T---ME-X------Xo?-M--X--?----?-X?-B----X?B-o-Bo-XX----------M--X--M--?----E?o---B-XM---X----E--E---?-E?o-o--B-TMT--E--o-o---?--EE-M---------B-M-X
E--?o-B--?-?--MoE|B-M?--E---------T--E---B----X--M?----|--E--M-X------------?--ME-B----B---B-B---E-o---o-------B---B---ME--X-ToE--M-MX----M----X?-oB---------MM-?-E--XB|-----oXo----E-------o-E-B-M-XoT|
B-M--MoE-----E--E|----------?----?|---B---?-B--o--B-oMo|----??-E--E-------M-M--M-----M-B--X?-M--E-----B--?--oo-o----------MM-|--EB----o-B--MT-?-----------------T----?-|T--BMo---------------MT-EM?B--|?
m----------------|----------------|--------------------|-----------------------T-----T-T-----------------------------T-------|--------------|-------------------|-T----||------T--T-----------|-------|?
XXXXXXXXXXXXXXXXXXXXXXXXXXXXXXXXXXXXXXXXXXXXXXXXXXXXXXXXXXXXXXXXXXXXXXXXXXXXXXXXXXXXXXXXXXXXXXXXXXXXXXXXXXXXXXXXXXXXXXXXXXXXXXXXXXXXXXXXXXXXXXXXXXXXXXXXXXXXXXXXXXXXXXXXXXXXXXXXXXXXXXXXXXXXXXXXXXXXXXXX
