-?E--------------------------B-----------------------------?------------------B-----------X---------X---------------------------------E--------------E--------------------------------X-----------------
-----------------------X-?-----------------------------------X---------------------------?---------E------------------------------------?----------------------------M---------------E----oX------------
-----------------o----------------------B--------------------o-?--------M-------------------------------------------------------------------------------------------------------------------E------X----
----------------------------M----o--------------------------------XX-----------------------------------------------------------------------B---------------------------------------------------------X--
----------------------M-----------B-----------------------------------------------------------------------------------------------E---------o-----------------------o------------------o-----------X----
----------X-----------E---------------------------------------------------------------------------------------E-B------------------------M-----------------------------------------B--E----------o--o---
------?-----------------------------------------------M--------------------E-----B-----?--------------------------------------------------------X-------------------?B----------------------------------
-----------------------?----------------------------------------------------------------------------------------------o--------------------------------------------------------------------------------v
----?------------------------------------------------------------------B-----------------------------------------?-----------------------B-------------------B-------------------------M-----------?---f
----------------------------X-----------------------------------------------------------------------?------T------M----M----X---?-o---------------------B--------------------------------------------B-f
---------------BB-----------E-----------------------------M------------------M-------B--------------------oX------------------------------------------------------------M-----------?---------------X--f
---------------------------B----------------------------------------------------------------X-------------------------------------------E------------o--Mo---B------------------------------M----------f
------------------------------------------M-------------X-------o------------------------------B----------------------------------------------B---------------------------------------------------o----f
-X-------------------X------E---------------o--------------------------o------------------------------------X---?--------------------------------------------B--------o----------------XMB-------------f
m-----X---------X-X-----------------B--------------------X------X-----------X-X--E--------------X--oX-?---------------X-----X----X-----M-------X-X--------X-----------------X-?-X---X-X-------X-X------f
XXXXXXXXXXXXXXXXXXXXXXXXXXXXXXXXXXXXXXXXXXXXXXXXXXXXXXXXXXXXXXXXXXXXXXXXXXXXXXXXXXXXXXXXXXXXXXXXXXXXXXXXXXXXXXXXXXXXXXXXXXXXXXXXXXXXXXXXXXXXXXXXXXXXXXXXXXXXXXXXXXXXXXXXXXXXXXXXXXXXXXXXXXXXXXXXXXXXXXXX
