XBME-MX--E--oXMXBB-Xo---B--BM---B--?XEooX-XMEMo--MXB?-X-oE-o--B?-EM--ooE-E--M---E-X-XB-BMoB?-BBEB?M-?E---B?E---B-Mo-XE-B?B--T-MMXXX-o---o??--M----E----X-Bo----o-o--M?-X?-XX-X?o-X--MB-X?EE-oB-B-E?Eo?-B
???----??M------BX--B-?EM-oMM-XX--MX-M-----M-oME?-MoX---o--o--BBM-EXoE?----X?B---o-M?M---?B--B--o-E?oBB?XoEMX-----X---?-MX--|-X-?XE-?B-T-E---EMoB-o--EE-EM--B-X--E--o-M-oo--EMMXMo--?--B----X---EM--M-?X
Eo--X--M----------?-X?-Bo-EB---?T-B-?--XXX--TE--E----T--Xo-B??---B-M-MM------X-----XM-E-M-oB?E-?-o-BM---BXM?--M---BT-oXX--X-|EX-o--o-EE|--M--XE?-M-X-MXB---o--EoMTXX-X-X-B-----?o-o?E----M----?--X?-Mo?E
X-----?---TM-?-E-?BEE----o-E----|-?---M--EM-|---XMBB-|B----BE---o-XE-----o?-M------EB-?--B---T-M-----XE----M----T--|--M----o|o---M----M|---------M-M--?-E---M-TEX|--T-M---------B-----XT--XB-----BT?-B-E
ToMB--T--o|-X--o----B-----?-E---|----?--B-MET----o-?-|--Bo---B?---M-E-B-?-E---?------ME-?E--MX--EB-M----E-T--XM-|--|--------XM---oTM-T-|----B------?--------B-X--X--X-o-----o--X-X-?E--XM-------T-|EB--X
Bo?--BXT-BX------oo-----B---T--T|X---B---T?-|M-----BEX-B--E-----o--o---o------o-?-----B---X?-oM-?oB--?---oX-ooE-|Eo|----o----T----|?-|--o-----T-------X----E-----E-B---EBo-T-?---------------T-E|-|--o-?
M--BM-MX--------E-----?----o|--|X----Eo--X--X--o--o--MBM---E---?-----Eo---?-M------------?o--M?-T-----------B--E|--X--??---M-|--EXX--X-XM-----XB---------------XB?----B----X------?--M-E----EX--X-XTM--M
T--------BB----M-oM---o-M---X--|---??------M--------------B------X--T-T---E----M-o-----B--o-?BB-X----------?----X---T--M-----|--o---TB?E-?-----------?-?o-M------oT---T----MB------B----M--M-----o-|M--v
oE--------o-----E--M---E-------|T----?------T-------X--oB-M---XM-E--X-|oTB--M-M--M--?--T-------------E-----B--oM----|--o----o|-E--B-|--M---B-X--?---T?---o-o-oB--?T--TX---B---T--E--X----B--T--E---|--MT
o-?o-----MTEoB-T-BM----E-T-T--XXXTB---M-----XB--?--T---oBXT--B-MMT--?EXET---E---BE-MM--X-o---M---BT-EB----T-EB-?----X-----B-------E-|-------------?EX-o-o---B?---E|-E|-M--EB-BX------B----oB|B-----XM--?
?------?--X-E?-X-Eo--o---X?|-M--E|--MX----XEM----E-|-EM---X------X-EB---|----?o?--BB----MEB-----M-X?B-o-M-X--B-----B?E-B-B---X------X---B?--B----oT--------B-oT---XE-X-MME--M-oE--o--E--o--BX--M-M----E|
X--o--------------?--------X-----X--------------E--X---E---Bo-T----E----X-M---B------T-----M---------M---?-------M---T------?--------X--oETo------X-X--?------X?B----?---?----B--------B-------------T--
------------------------T---T----------E--------T-------------|----?-----------------X----T---B---T-----E-----T------|-T--ToM--o----------X---T--------T-------------T-T--X--o----T-------TB---------|ET
ET-------T-T------------|---|-----T-------------|T--TT----T---|--------T-T----------T---T-|-------|-----T-----|------|T|--|TTTT-------T----T--|-------T|-------TT----|-|M--T-TTT--|-------|-----T----|-o
m|T-T----|-|-TTT---TT---|T-T|--T--|---TT--TTT--T||--||TT-T|---|T-TT-T-T|-|--T---T-T-|--T|-|--TTT--|T--TT|TTTT-|T----T|||-T|||||--TTT--|---T|TT|TT-T-T-||---TT-T||--T-|-|TTT|T|||TT|TT-----|--T-T|T-TT|--
XXXXXXXXXXXXXXXXXXXXXXXXXXXXXXXXXXXXXXXXXXXXXXXXXXXXXXXXXXXXXXXXXXXXXXXXXXXXXXXXXXXXXXXXXXXXXXXXXXXXXXXXXXXXXXXXXXXXXXXXXXXXXXXXXXXXXXXXXXXXXXXXXXXXXXXXXXXXXXXXXXXXXXXXXXXXXXXXXXXXXXXXXXXXXXXXXXXXXXXX
