o---o--B?-?oX--Eo-o-o?---E-?BE-o?XM-E--o-----EEooEE---o-XoMo-M-?-B-----E?-M---?o--BX?MoB??BoX--BMoo?-EB-?--X?-ooXE-B?MX--??-EEBMMMB?EXMX-BoM?oM--M--B--?-BE--oE--?---B-XMMEoo-X?XB--MMMB-M---o-?Xo-XX--?
-B----oE-o-MX-E--X--BE-?--XXBooMM---BEMXEX??-XM-oB--ME---?XX-?-E-M-E---M--X-?Bo-?---MEBEB---M?--BXo?X?XXMXE---oM-EBoMMoXXB?-X-----?XBXMBoBEB---BXM--E-E-oX-o-?---X-E--?--o?X-EM--X--EE--M?-??-MMoXXXXE?M
|XBMo------??---o-M--M-----MXEB--X---XoM-M-?-?BX-?Mo---?o-BB-?Eo-XXoE---EEMEo-XXX--oE-B?-M-E-X?M-----o?M?oBE??-EMB-TEX-XoE--?EM?EE--o-Bo-EBoXoMBEXEB--M-?ME--XB--M-E-X------BME---MoEEBB-XXTX-M--B-o-o?X
?--TX-E---B-B-MT--o---XBB-?B-----B-o--XMXB--------MX--o---Mo-?----X---X?---o------o----X--B-----EB----M-?-----?----|B---MX?-B------T-B-EX-MT-?--?--?--M--X----o------?--------------?E--oBB|----o--BE--E
XXoX?----M-----XB---?E?MXT----E-XoB-o------E---M-o-M-EE--X--?-MBB-M--E??-----------??---o---X-XXT-?X-T-B-X?-B--o-EB|----M---M-o----|M--ET-o|M--?ET--MX---oB-BB-?--M---M-E---X---------T-?--X---?B---E--B
TM--?-X-E--M--To---------X-----oo-----X--------?------?EE--B-X---B--M-M-o------E-o-B-------XME?M|----X--ToMB----B?-X------------?-MX-E--|oBX-----|EM--E----B-------?---M?--oE--X---X-oX---------T--M---X
oB-?-E--TME---X--BB-----M-?XEX----o--M-----T----B------EBB?-o----B------EM--T--?-------E--oE---MX-----?-X---X-MB----oBB??----?MT-X-BET--|--------XB-X-?M---EE----X-ETX-M-MMM---MB-BB-B------?B--|M---o-M
X?o-E---|M-??XE---?----M-MMB-o----o-X--M--BX---?-E--B-------?--B------------|--------?--E--?M-X-----XE?-M-?M-B-o-B-?o-M--?B----|-----|MEX-----XB-------M-------B-EX-|---M--B---?------E---o-----X??---Ev
B----o--|------T---E-?----B-----------EB---M--?--?X--?o---?-E----M---oX-?--oX----B--o------?---E-ME---M-o--------E-E-o---EB-M-?|-----X---?MM----oE-?--?--------B----|-BB-?----------Bo-------M-----BT---
Eo----E-X---M-MX---?------o-E-oE-----E-B-XB--o----o--------XE---o--o-B---?--EX-E-B---M--oTo--XXB-M-MX--Eoo----o--?----B-E---B?-X?-BM-B------E---TEEMX-----M?--------X---M-TMEE-M-XX-T----M----oM---E|--o
|-E-M-M--BXB---o--X----?BBMX-o--o-M-----B-B-X--B--o---EB----?E----M-?--ooBXEMM-E-?o?--B--|--o---B-B--X-----MX-B--E-----M?BM--oXEo--B-BMo---EM--o|--EM--EE--M---------?-?-XX-M?XM--M-|-------oB-?X---X-XX
Eo--B---X---B---------M--T-------X---o-o-Too-----MM-M-T-------?X-M-o-XBM--?---M--B-------X---BM---?E-------o--M-?---M------TX-----E-XT-----?MB-TTEo-------M-------o-----oMT-----?EM-XX-----------XB-B--T
B-E---?----------X--o---E|-------o--oE---|-----B------|E?XM----BM----T-------o----X-----MT--E-------MXTM?-E--T----B-----E--|----To--MXE------o-||--M--X-XB-o-?------------|E--Eo---------------?---T---X
T-B---------------o------|-T--------T----|------T-----|---M--T--B--T-|---------------?---|------------|-T--o-|-------------|-E--|?--T-------B--||T----E-T--o--T-----M-X-To|-----X-E--E-----o-------|---X
m---T-----------T--------|-|T-----T-|T-T-|-T----|-----|T--T-T|-----|-|----------T--T-----|---------T--|-|----|----T-----T--|----|-T-|----------|||------|-----|--T------|T|------------------------|--TE
XXXXXXXXXXXXXXXXXXXXXXXXXXXXXXXXXXXXXXXXXXXXXXXXXXXXXXXXXXXXXXXXXXXXXXXXXXXXXXXXXXXXXXXXXXXXXXXXXXXXXXXXXXXXXXXXXXXXXXXXXXXXXXXXXXXXXXXXXXXXXXXXXXXXXXXXXXXXXXXXXXXXXXXXXXXXXXXXXXXXXXXXXXXXXXXXXXXXXXXX
