|E--o----XX?--X-MXXMXM-M--??M?E---?----?--E-o--E?BE--?-B---X-??-M-o-MM?M?-X-?M?-B-BE-M-X--E?-?---X-B-B-XB-MooEX-?M?--o-M-XX-B--M?-B----?B-----B---?-Xo--XBX-BM?oM?MB--EX-X--ME?EX?XM-?ooX-E---E-?-EM-MBT
|-BXM?M??-MEMB-Bo--?-E-XM-BoM-B--o-EoBXXEo-B?--?o?-MoE?-oX-M-Eo-BE-B--B-?--BM-XE-o-Bo?-MM-oX-BX--XX?-M-o?M--B---M-?---?EEB?XoMX-?E--BM--o-?B-B--B--o-BM--?-oM-?------o----oTo----Eo?-?---?BE-??----M-B-o
oM--------oB-M-o--M---MB---T-B-----------M-X?-o----M-MBE--Bo?X?-BoE--M----?---o---X?oMBE--o-MoE-?-o-M--M--oB--X-MoMX-X---o-M-X-----Xooo-o-ME--E---M?X--?XM----X-M-X-M?-E-B-|--MMXEBM-E---o-B-M-M--M--o-o
|---X--MB-------B-EM-BXoE--|------oM-o----X---X-B---o---B-oX-----M---?--------------?-M----MX-?----X----M-------o-----BE-EM---E----E---EMoB--EE-----M--MB--E---BEB-B--E-?--|---o-B--B--B?-X---BM-------o
|-M--B--M-M--o---X-------?-|o-?X--------------BX--XM--------E--BBo----?M------o------XB-X---o-MEBEX-o---oM------B---X-E-?--------?-----T-o-EX----------M-------?-B---?--TBBX--?TB?-XE-X--E-X------XoEMBB
T-o-M---?o--M-B----?--X-oEo|-B-M-----T?o--X-E--B--?-MMMX------XBB-B-----Mo---X?M--------B--o-?o---B-M--B---B?--o--E--MBB--M-B?-T---Xo--XE---?------oXX-?o-----B---X-----|-o----|----E-?-BE---T?---E---TT
X--------?-XoM?BB-X?M------X-E----B-X|-------X-M---o-o-------------oo?T--oB-----BX---?-o--E-X--X----E?---M-E-?--oMEo--M-B-----E|B-M--B-MB--------E-M---E--MM--?-E-o-o?X-|--T-E-X-oE?-----M--B|M--?B--B|E
o---M--------B---oB-o-?ooX-oM-------EX--X-MB------o-E-o-B----?------o-|M-?-XB-----------T--------------M----?M-X?--B---?--E----|------?-----X---------??B------o---?--oX|--X--X--M--oBooETB--XE-----M-Xv
T---MX-Xo--BTB--------M---EoM?M------o---XT-X-----?E-o---o------BEBo--|---M?-ME?--M-----|?-XM-----o--XX--BoE-T-----o--E---?-o--|X---M-----MB-?---o?------M---?--XB------XB-----B?B-o--?--|----o-------o|
B--M--M-oB--XEX--o-M?---?-M-??E-X?--E--B--|----MB-?-E-X--EX----?-BE---|-X??--E---T---BM-X-X---------E-MM??oo-|?-EM-----?---BB--X--B---E-X----?-M--o-----B-?---oE-?----o---------E--------|---X--M----B?|
X-E-M-?--oBEoM-----M--E---o-o?--B--XoXX---|?ETXEM?-----E------X-???-?-XoM--oE---M|----?--oB-XXM---T--B----Eo-|EoE---M---?X-?----M-B--M-o-M--?B?EB-B---M-B---B---------o-XXBo--?MB----?-o-|----X--EX--B--
?----------?--T-B-X-------EM--M---BE-?---XX-o|--E---M-E-o-M---M-B-B??-oT---------X-------------E-M|BX-XT--EE-|----------o-EM------?M---Mo---T-o---E--M-oM-MEB---------------E-ME--ME---E-X-T---X----T?-B
o---------o---|------TE---MB--------E--------|--o----E-----------?-----|---------------E----B---?-X----|--E--XB--T---o-----?------o---------X-------------------T---------X---?---T-------M|-o-BE---|M-o
--------------|-T----|------TET--------------X?----M-----T---B---TT--BX|--------T-----T-----?---E-----?|---------|------T?E------E---?---T?---------B------T----|-T-T----------M--|T-BT----|X-----M-|--E
m-------------|-|--T-|------|-|T---------T---T------T-T--|---T-T-||--T-|---T---T|-----|------------T---|T-T----T-|T--T--|------------T---|T---T------------|---T|-|-|-------------||--|----|---T----|--B
XXXXXXXXXXXXXXXXXXXXXXXXXXXXXXXXXXXXXXXXXXXXXXXXXXXXXXXXXXXXXXXXXXXXXXXXXXXXXXXXXXXXXXXXXXXXXXXXXXXXXXXXXXXXXXXXXXXXXXXXXXXXXXXXXXXXXXXXXXXXXXXXXXXXXXXXXXXXXXXXXXXXXXXXXXXXXXXXXXXXXXXXXXXXXXXXXXXXXXXX
