oBX?--o--o-E-MM-o---EX-?-M--BXBB-?BXX?BB--X-B??----BX-E--Eo--o---E-?EM-o-B-ooEXEE-M-oX-?-o-?o-E?---XM?XB-o?MX?M--EEX--?-----M-X--XEM--oX-BX?-E-EXBM--?-o--oXEoB-?--E?-MM-XEE--oE--BX?-X---B-EXo-?--EX-TE
E-M-oXM--E?E--X-B----XB-o-o--E-?EEEM------Eo-MB----BME-X--M---XX-oX-EMB--------BME---XX?EBB-E--B-o-X-?--B-XE-?----X-XEME?---M---Bo-Eo-X--oX--M-Mo?B-Mo-TB-E---------XE-o--M--o----?-?-XE--M?-BX-oX--?B|-
X-oo---M----TE?---?-?--M-?MXB--M?--E--E?XMM?--MB-oB-B-B-E----M--?----E-X-E?-E-?----M--M--M--?B---MME--XB-M-?oM------XEEX----??E------o?--?--X-E-?-o?MX-|--Mo----E--TXXX--?E?---E------B----E---X-M-oo-|?
XB--E-----M-|---X---------------?---E-EBoB?---?-XX------M--B---E-E--o--E---MX--B---?o--o-Mo----?----Bo?---X-----X---E----o----------BX-M--E---?----oB--|----M------|o-?-T-o-M---X--EB-T--?-----MoX?-XB|E
E--?--?-M---|-EB---------------M---oo-------E----B---?-oE-B---E----------?-o----M--T-BTB-B---M-----E-B-?----?BE---?-M-?----?-B--EBE--?E?---M------M-oBoX--------T-TXo-M-|?--o--MM-----|-----o------T-?X|
?B-BM----E--|----o------------T---?--E----?-E--E?M--?-EB-BTB----X-B---oBB-?----T---X-M|---------------M-T--?-----ooMM-o-o--M--E--B-TE-----B------------o?--BB---|-X-----|M-------MT-oo|--------T---X-ETM
M---E--oEE--X---o------Xo-?X-M|----MM--oB-o---?-----B-----|?------E-----?B----?|--??o-|-------T----M-M-B|-----??----B-E-----ET-X---X-T--T--E---TX---------------X-----o?|---Too---|?o-X---o?-?-|-B-Eo-|-
EX--M-----B-?B?-?B--X-----?---X---o-----------ME---T---B--X--B-T------Xo--M-M?-|--M-BBX---o-ME|---?BE-T-|----E-M---?-MT------|---M---|--X--M-?-X------o----M----o-------X--E|-?-T-|-E----T---MoX--T---Xv
E-M----o-E---?------?-E---------B--B-T------?------|-----TT----|-----o------?--X--oE?-EM---E--Xo--M---|-XE-?---E------X---M-o|E-M--M-|--B-E--EM-E-B------E---X--o-XX-------B|-B-X-|?T?--BX-M----ET|-M--|
X-----------E-T--B?--Mo--o?B--B----To|----E-B-M----|--?-B||---EX-ET-MB-M-???----M--o?---E--------TBTo-X-?-?-T----M---?Eo-----XB---oM-|-B-X----E--B-EoEo-?---------T--T--E---X-----XM|B----oM-E---X|?o?-E
M---M-MBB---?-X?-B?-----?-------B--X-X--M----E-?E--X---o-|X------EXE-?BMo-oB---B?--ooM?-Mo-E--M--X-X--Mo----|o--EB?---?-o--M?-?M-----Xo-ME--T--?--??M-E----------EX--X-B----BT---?M-Xo-----B-oB--B|oEE-B
M-------o----X----M-E----oT------BTM---------------o-----X-X-T----B---------T--o------B-M--o----o--------T--XoTT--ME---------T--E-T-B--B-Mo?|----------oE---o---X-M--T-------|-----M--TTTM--TT?-X-X----o
?---?T----o----T-TBT----T-|-------|---ET-T---?-E-T-----o-----|---E----------|----T---E------------------E|--E-||-----B-ME--To|-ToE|---------X-------T-M-------------?|-------X---T--T-XX|---||T--------E
o----|--T---T--|-|-|----|-|--TT-T-|----|T|-------|--T-T----T-|---------T----|----|-------T---------T-----|-TTT||--------T--|-|T|-T|----T-------T----|T-----T----T----|-T--T----B-|--|---|---|||--------M
m-TTT|T-|TT-|T-|T|T|T-TT|T|TT||-|-|--T-|||-T---TT|--|T|T---|-|T--T-----|--T-|T--T|T--T-T-|-TT---T--|T----|T|||||T--T----|-T|T|||-||T-T-|TT---T-|TT--||-T-T-|T---|-TT-|T|-T|-----T|-T|T--|-T-|||--T----TT
XXXXXXXXXXXXXXXXXXXXXXXXXXXXXXXXXXXXXXXXXXXXXXXXXXXXXXXXXXXXXXXXXXXXXXXXXXXXXXXXXXXXXXXXXXXXXXXXXXXXXXXXXXXXXXXXXXXXXXXXXXXXXXXXXXXXXXXXXXXXXXXXXXXXXXXXXXXXXXXXXXXXXXXXXXXXXXXXXXXXXXXXXXXXXXXXXXXXXXXX
