M-B?---M-Eo-X?---Moo-o--oB?-X--ooM--EMBEB-XM-EXBX-E--X--XMo--E--XB--EEoEE-ooB?-MoBB?-B-X?o-o-M-B-o----E-MBXX?-B-XX?-XE-----M-?E--XMM--EEM--?XE-?X-M--X-?-ME-EX--E--?---ooXB-MXE-Mo-oBo----o???X--Eo-E--E
ME--Xo??--E--X-B-E-BM?-B---EEX------B--?-?-B---EB---MB-EEo-XEBEoX-E-oB-ME-B?-B---?XMoEM--o?oXMoXM---X---?E-?-B---BE-XXBBM?---X---oX-o??-Xo---BXo--XTBME--XXE-XE-M-o--oo--?MXM-BM?-M--EE-M-EEX-oo-oEX-B-T
--?---MX----XXE-oBX-BM-o---XEBM-M?oBB-E-X-E--X--EEEX-Mo-M?EEX----?o-?EE--BXE?--X-BM-M---Mo-E--BMXoo-?o--Mo-XBE??-E-B?---o------EEEB--BoBo-MoooEXE-X|-??------EB-M---EMoX-------M----M----BX?o-o-X--EooM-
M---------------X-Eo---B---------XX-E---o-?-?o-------??XE----M--------o----?EM----oEoTEX--XB-X--------M?E?----o-------M-EB-------B-X--E--oB-EB---X-|--------M-M--B---------?MBB----T-----?-----B?-M----M
X-MX----XE-o--X-----E?-E---XB---Eo--?--?-------------------B?--MX----E?---X-oBX-X---BXE------ME-o-?---o---X---?Bo?X-ME---M-?-?X-?o--oT---E?-M?--?EBX---M---X--------BX---?-------E--E-M-E-X-----------TE
X-ET-----?-oM--X?--E--------M-EE----B--------MoE-o?--------?B-------------E-----M------X-M--------?-oX--------MB-------B-ME-o-M-?M-X-X-M--B-B---T-M--B---B-B------E----E--B--X----XXE-M------B-?X-Mo--XM
-B-|--?--Mo-----B------o--o-----B-----B-M----B?---o-----X-B-EB--XB---?--E----oX-E--M--M-?--------T---?-----o--BE--X-X----------M-B--XBX---B?-B--|E-----BM-o---E-BE-o-----M--EEE--------B-oBTX----------X
B-M|E--E-----oE--B-----B--T--MM---M--M---MX---E--B----oB-B-----B-----B---M-X---o--EB-----X-----Bo|?--M--?-B-E--B-X-?---B--MX?--E-?-B-----?--B-o-|-E--B?----M--E--T---EMX--oBo-----MBX-o----|----XMo--T-v
|--X?--EMo----?-o?E?-o---E|------X---MM--EBo--oXEB-MX--?E-X------o---?---M------M--oo-----------?|-o--B-EE----X--o--------?M?-------X?--?-?-BM--|------E-EB-X---MX-o--ooM---BM---o----TTB--|--BX----?|-B
|-----T--M-M----------X-X-|?-----T----------M?EEM-B-E---MB--?X---E-------E?---E-BX--M-B--------E-|-------E-BXE-?E-?--?EEM--o-o-------o--------?-X-E-B--BB-----E--------BM--X--------BX||---XXM-----B-XT?
--BE--X--?ME--X-EB-M---B-EX-MoB-MX-M-------M------o---MM-?M-E---XMM-X---BME--------B--E-B??------X-BE---o----E-MM-o-E?----M--B-------oo------E-------X---X-M--?E-X-?EE-M-----ME----M??XXE-----E----M--XM
EB--?---E---------E-?------o--E--?----Eo--B--T--B--?EB--MT--MMX----BE---BB----oX--------------M-----------E------------EB--T-?----B-BM-MM---oMXM-E------B--------T--T-----T----X----M--MBX-----?T-B--B-T
E?----B----------B--T----------------X---?---|-------M---X-----B--------------M--------o-----To-E---XX--E-----B-------o----|T--------?X----??--B--XM----------o--|--|----X|----?-----o----------|------?
oo----?-------T-----|----------------o----T-T|----------------------------?----T--------o--M-|-------------T-------o-------||E-------ME--o-T---E--TT------T-T----|--|---B-|--TT-----------------|TT----X
m-T-T-T-T---T-|----T|------T--T------T----|-||---------T--T-T------------------|-------------|-------T----T|-T----------T--||------T------T|----T-||-T----|T|----|T-|-----|--||T---T------------|||-T--|
XXXXXXXXXXXXXXXXXXXXXXXXXXXXXXXXXXXXXXXXXXXXXXXXXXXXXXXXXXXXXXXXXXXXXXXXXXXXXXXXXXXXXXXXXXXXXXXXXXXXXXXXXXXXXXXXXXXXXXXXXXXXXXXXXXXXXXXXXXXXXXXXXXXXXXXXXXXXXXXXXXXXXXXXXXXXXXXXXXXXXXXXXXXXXXXXXXXXXXXX
