XE-BEXB--X?M-EE?-E-?B--B--EX-E---M--oMX-M--M??BBoB-?-E-o-oM-----?-M?-E?---EoX---?E-X--MB------?--X-o?---E--E---?B-M?-----XB?EEM--M--MB---M?-X-?-o-oEXM??MMB-o-?X--B-MEX?--?-BEXoXM---X--o--?-XX?B?XBX--o
?E-E-?E--?EB--?--X---?Eoo-oo---Eo---X-E---B--XEBE-o?--X---?X--?oBo----M-o---XoEM--X?--EE--oX-oBM----oM-MEo?----XE-XMXXXo--B-XEo?---X-M?-BEXB---M--M-o---E-?---B--?E-Xo--E--??MMXo--o-?M-XEEEM--o---Mo?X?
E--?--B---?E-MM-----?-E---B?-XM--XE-B-B----E--?-?o?-Boo--XBo?-o-BXo--M-?oE-?-?---M-o--o-E-B-B-----EBX-o-o-M--Mo-E--EMMB----Bo-B?E-E--X--?Eo?--?-M--MBEM---M-X-?XB-?-?B-X--?-E---E--?B-X----o?-?-MM?X--Eo
o--X----EB--BE-?M--o-?-------oo--M-T----E?M?--?--?--------------E-o--o-M-----?-M--E-----B-B---M-----------MEo-o-XEM-----X----M---T--E-oBoB-----T?--B-----EoE-X---E------X-----M-M?-B--------------M--?--
|---oB-M-------TM----MB-oE----o--oM|-----E--B---E-X------XE-----o?--E-----?--o--XB----X-BE-?o-MM-MX--X---oo--?----M-------E--TX--|--o--?--X---E|-----?-o?-?E--B----X?-M--X--?---------X--X-----E-----?-T
-----E---E-X---|---T-?-BB------M-M-X------BX-E-------BE------X--B-B-o-oE---ET--B-??--X---?---?E--o----XM-o--M----E----o------|MM-|--MEEBEB----oX-E------?B----Mo-?--B---EB-----T----M-o----E---MX-M-?--?
X--?oo?o--oo-X-|-?E|--Mo---?---BM-o-----?----oB-X--B--TM--B--?----?XM-----?-|-E------?-E--oB--E---------?-----E-M----------o-X---X--B-------E?------oX--------------------T---M|--?T-E-------X--MX---o-T
MT----oM-BM-X--X-o-|--B?----X--E?---?----??-----?-BB-?|---M------E--M-M----oX-M--M--M--E?-----B----?BB--EEMT---X-?--B--B-B-----EM---T--oXX--oME----XM?----X----------Eo-XXX--X-|X--T-----E-------E--BoBv
T|---X-B----o--MX-EX----XT---??E---XM--EEM----X-B---Bo|----------ME-o-B-------?o?-M?EEX-oX?--X--B----o----EX----E------MX--Xo-----XBX-M-To-----o-------E-XoX-E----X-------oX--?|---|o--X---MM-M-E------M
BX-M-E--X--?---E------E-M|-----Eo?X-M---?MX--E--o----BX-E-E-----??-M-o--E----o---M------E-?-----M-o------o-----B--o?----B------?--------|-----X--o?----T--MM--Bo--BM------o----X---X-----M--E-??-o--XE-o
M-M----X-MMM----M---Eo-M-X-o-?-E------?--?---------?-?M-MM?----oB--BE----XX--o-Xo-BMB-MB--M-?M-?E--B-B---M---B------E--M--Xo--M-------EX|-M-o---M----M-X------B--Mo-BEM-?-----EE?-BEB-?EE----E---oX---XE
o---?-----T---E-------------?--T--To-------o?M--M----o-o-E----X--M-----X----------MB----o----M---?--E------o--?-TE------------------?-TM|-Moo-----E-o------B--E---B-TE-T-E------T--B---?-o-?-----E-M---X
E-X-E---?-|--X-E---X-----X-----|-T|-----o-??--TT-----------B-o---E--T---EX---T---------?-T-----------------T----X-T----E-------?------|MX------?-----M-------X------|--|--B-B-M-|-------------M--B----T-
oT-----T?-|To--T---------T----X|-||--T-o-T----||E------?-------T-T--|-----T--|T----------|T---T------------|Mo----|-------------------|oT--------T---Mo----?-T-----?|--|B-----TB|E--E--T-----MT-T---M-|?
m|T----|--||--T|---------|-----|-||--|T-T|----||--T----T-------|-|--|--T--|-T||T---------||---|-------TT---|------|-----------T-------|-|--------|---T-------|------|--|-T----|-|T-----|---T--|-|T----|o
XXXXXXXXXXXXXXXXXXXXXXXXXXXXXXXXXXXXXXXXXXXXXXXXXXXXXXXXXXXXXXXXXXXXXXXXXXXXXXXXXXXXXXXXXXXXXXXXXXXXXXXXXXXXXXXXXXXXXXXXXXXXXXXXXXXXXXXXXXXXXXXXXXXXXXXXXXXXXXXXXXXXXXXXXXXXXXXXXXXXXXXXXXXXXXXXXXXXXXXX
