---------------B-------M?------------------------------B------------------------------------------------------------------------------------------------------------------------o---------?------o--MX--
-------------------E-----------------E-----------------E------B-------------------------X---------------o----E--------------------------------------------X--E--------?-X-----------B-------------------
--------------------o-E---------------------------?----o--------------o-------------X-----------------------------------M----M-B--------------M------B----B------?---------B----------------------------
--------------------------------------------------------------------o-----------------------------------------------------------------------------------------------E--------B--------------------------
----?-------------------XT----------------------------------------------------------------E---------------------------------------X----B-------------------------------------------------------M--------
------E----BB--?X-------?X---------E---------M-X-------------B------------------BX--------------------------?---------------B------?--------------------------------------------------------------------
-----------E---------------X----X-------------?-B-----------o---------M-------------------o------------------------------------------------B-------------M----------------------------------------------
-----------------------------------------------------------------------------------------o----------------------?---------------------------------B----------------------------------------E-----------v
----------------------------------------o---------------------------------X----------o------------------------------------------------------?--------------------------------------M-------------------f
--------------------------------------------------------------------------?----XM------------------------------------------------------E---------------------------------------------------------------f
-----------E--------E-------------------------?-----------------------------------------------------E----------------------------------------------------------------------------------------------X---f
--------------------------?--------------------------------------------------------------------------------------X?-------------M-------------------o---------B-------------------------------------X--f
--Eo---------T------------------------------------------------------------B---------------------------------------------------------------------------------------------------------?------------------f
-----------X-X----------------------X-------------------------------------------------------------------------X----------------------------------------------------E---XT------------------------------f
m-E--------XX-----XX---X-----X--------B------------------------oEX---------------X----B--?----------------X--X-----------------------------X----------X--X----X?--?-----X-----X-------X--------X-------f
XXXXXXXXXXXXXXXXXXXXXXXXXXXXXXXXXXXXXXXXXXXXXXXXXXXXXXXXXXXXXXXXXXXXXXXXXXXXXXXXXXXXXXXXXXXXXXXXXXXXXXXXXXXXXXXXXXXXXXXXXXXXXXXXXXXXXXXXXXXXXXXXXXXXXXXXXXXXXXXXXXXXXXXXXXXXXXXXXXXXXXXXXXXXXXXXXXXXXXXX
