X?BX-B---M--o?-?oB-o---M-E------E-M--M?-ooE?---??EEME-ooo-E-XEXoX-E--oX--X-oB-----E??-?oB-X--E-BB-B----XoB--XB-M-Eo--XE-X-M?B-E-oooB??Bo?EBMMoB-M-EE-MMoXE--o?B?BE-----B-M--Eo--o-?--MEBMo----M?X-MM--M?
XB-MM--Boo-ooo-EBB-BEEEBX--BM--o-?MXM--EoM?---M?oM---oB--BB-M-M-EoBX----M?BE--------B----Eo-MX-M-M-EMXMoE-MBoM-MMX-XMo?-XE?--EEM---B?E?--EoB-M?-E?BE-Eo-B-oXBM-BME--oX-B?-ME?oBE--?E-E-o-E--BE?-------o|
|-oB---B-BX-M-E?XEo-X-BoM-MEX-M-o---BoXB--XBBM-?---BB-E-??--BB-B?-oBoMBM--ME?M---o--?--B?-XX?B--o---?-X-BoEME---M--MMoo-B-----B-B-Xoo----o-BB?-?-o-o-E?----EoMoB---o--EE-o--E-??--ME--XB---o----BE?-BoB?
B?--oM-----Eo-o--E-BoXBBEE?MX-MB-oMXoo--o--XMo-oXX--o-MMXBE-E--o-X-B-o-B---X-?E?o-M--oo?M----XoXE--?EE---?-MM-XE?X-X-M--M--M--MEMMoXo--?-ME-X?EoM--BMMMB------?BX?Bo-oM---X?Mo---MX--E-B-B-oB-X-?oE--oX|
T-EMMEME?---X--M-MoMX--oE-BM?-EB--?BX?--E-BMoM-oE--X-X---EE--XBXBBoM-?o-oEB-E-E?BEM-?--MB---X-o--MoMo-E?M--B-XM--oo--oE??MBB?MM-MEBEM-E-EEXBE-E-?o-XMBo--X-XMMX-E?-M----BoM-o-?-?-E?M---BM?-E-?B-MM-X?--
BBBEMX-BBXB-X----X-EE??--oE??--BB-------XoM?X-E?-BEX---?E-oMX-oM--MXoBXM-MXBM-??-E--?o--E----E?MXME-X----o--o-??--X?MB?E--B--X-oXXEME?-oB-E?X-E-Xo---BB-B-X?X-E-EM---Mo-o-?M-?-E--?o---??EBBoMXE-B--EoEE
o------?-??-?EE--?--E--B-o-X-MoB--X-oXo--XM----Bo-oBo-M--EoX---B-Xo-XE--EMEoXoBB?-?---XBMEB--EB-o?o-BM--?B--EBM-oooE?X-XB-oBo?-Mo-??B-o-MEo-XoE--EMME-X-E-?MM--?-?-MB-oEBEoo-?M--?-?EMMEoE?MMXE-M-X-BX-T
o-?BM?-EBBE-MB-E---XB-X-BoB---X--M?M-?E-Eo-ME-?B?--E-XEB-X-?M?BXBM-oM?oX??-X?XBoE---BM--Bo?MXM??B??B--E--oMEB--E--??MM-E?--BXEMBEoE----??E?-M----BE--B-M?X---??--MXB?B?-?XoXE--BXo?B??E?-BB--o-oXBMBX-ov
|-X-o?XBEXE---XXB-oBBE-E---XBE---BMo-X?E-oBo?--E--?-EM--?-X??--M?o-XE?oBB??E--E-X----XM-E?-o-?E---X-B--?----X-B-MBE--M--B-MXoBM-?o?-XB-B---BXB--?--XBX--------BXEBo-EB--o---XEoEX----M-BB?-o-?-XXBEo?XEB
--X-X--o--B-B--o---oXo---?EEM-XoEE-M-BB--MB-XE----X-MM?---MXMBMoBB-X--E-XEE-ooXoE-X--E---BMoBXXXo?MoB?MXo-oB?EE-E-M---o?X-?--XM-XBo?MoBEoBBE-MMEE-ME--E--XX-XE-?oB-BM?----?---MXEoBE--oEBo-B-o?X---oB--B
MB-X-B-BEXEX-----BMBXo-X-oB?-EXoE-B--B----E-M------?MoEEXMBMXMMEoXBE--M-MEBE---oM-oo-E--?-XX?-Xo-X-M-E--XBBM-EEBB-ME---?-B??-o-?-oBE-oB---B-?-?BM--?---B-?BBoBM-X?---Moo-EMB-X-B-BB--o--oo--oE-oo-X-X--T
?-BEB--oE-MXMEoo??--X-EM-MoE?--EE-ooE-BXo?XB?BE---B--E-E-??E-B-oM--E-X-E---X??M?B-?-M---Eo?XM-B?---oXBXB?-BE-?E?-o-?oB-M-?------M--MBBBo?-EMEMoME-E?-X-X?MBXX-XME--?Eo--M-?--?Eo?BE-XEBo-MEX--BE--XoE?-B
??--?oX?---BEXEX?BM--XX---?o-EMX--oB?--?oo---BMBoBXM?MooEEB?B-Mo--oME?--XE--EEX---?-M--oo-M--o-?M-?EX-EEM-X-XMXE-X?E-EB-EB-E-M-?MBo--?---?B-X---B-XBMoX?o-----?----MBM?oBE-M?o---XXBBo-EX-X-Mo?--?-?--XB
XE?EEE--oooE---oEXE--Xoo--oXoE-o-oE-Boo---?EoEo--EB-o?---EBo---XB--?E?E-MEM--oE?XB--X--X-M-B-B?o-oX--XooEBoE??E?Mo-M?-Mo-EX--?E-XEEM--Xo----?X-oXB-B---BXB-EE--o--E-E--EEE--M?B-BoX?-M-MEo----?B--M-M-EB
m-?-X-XMB-BEEXoo-----B-MBB--BBo-BM-E-X-?---BMM?-?-X---BB-o--B-??EBBM-Eo?B-XMEM-BEXB-E-M-BE?MBX---EX?XBoMEMoME--XBoX-oMXMMo--E?-X----?-ooX---o--E-E-oM---B?-BE?--?--MEE?MEMM?-XMX-BB??-M-E-?M-M-B---?BMoT
XXXXXXXXXXXXXXXXXXXXXXXXXXXXXXXXXXXXXXXXXXXXXXXXXXXXXXXXXXXXXXXXXXXXXXXXXXXXXXXXXXXXXXXXXXXXXXXXXXXXXXXXXXXXXXXXXXXXXXXXXXXXXXXXXXXXXXXXXXXXXXXXXXXXXXXXXXXXXXXXXXXXXXXXXXXXXXXXXXXXXXXXXXXXXXXXXXXXXXXX
