MoME?XEM-BE---MB-XBM---B-B?M--?---MBE---?BM-M-M-----?o-o--MoBE-o---M-o--?-EoB-o----B--?--?-MM-E--BoXo-E-o--?M--BMoX?-?XB-BB-B?-?--------X-E----o--MB--BE--oB----oB--EXEBB-X?-X-o--MXXBB-MoBMMXE-M----BT|
?oX----XX-M?-B-EBM??-X-oEE---Eo-E?---E---X-MMXEE?--B-E-?X??E?---EXoB-MB-E---BXM--BM?--?M--X-XX-oE-EE--MMBE?-EoB-XM--?XEMo-oXM--M-?-BM-Xo----?---o--M--?-BE-X---?-MB-X-----M----MoBX?-B----B---oEo--BX-|-
M-XX-X---?E-E----Eo?-X-E----oXE?---o-Eo-?------o---o?--T--?X-?oM?-B--o------B-MB-X-XT-X--?--B?---M--?XXEo--X?E?X---o---MX-BE-M---BEo-o-----XBX-EX-o---?-?B--E--E-MoE--BE-M-E---??-X----B---o-oBB?M?ooE|-
M-o--?XoE----M---------XM---X------XXX-?---??----E---M-|-B----MM--XB-M----BoM---o---|---E----XB-M-M-------T---B--XE?X-XM??--------?B--TBE----oX---B---B---B?T----EEM--B-X-----?-----X---------Mo-----o|M
|---o---o--T-M--X--oo--?-E??-MX-XE---ME--?-E-oT-------XXMMBM--B--M?-----E-o-----M---X-o----B----------E--o|-----B-E-----M-MEo----Mo-E-|B-X--oM--B----o----BTX--MMo-B------B---------M-TX-ME-----M-B---XM
X?--?------X--------Bo--?----E--o-o--?---?M--BX--X--oM-M---MB---XB------M------XE----------?-----X-B-M-XM-|--BB-M--?----?-?o-o---EB?--|---------------?-X?E|-o---?---EE?--E?B-X--EB---X-X-----?Boo---o?-
o----E-BBo-M?E-E-----EoE---B---o-----?-----X-M--E-?--B-B--MM----B--ME-X?--EoM?--E--?-B-M------T-MMM--BEBT-X----E---B------------------X?-------B--B--M--oMEX--TM--------XB--T-oo??--B-E---o-X------B--??
E-M-?o----X--EB--EEBB--o-o--T---MEM--?------X?--M----E-E--?-o-----M---BM----BM-M-B---?-M--?---TB---?----X-o--?---?o--X---o-MEE-XEMB-o----XB?--?-------X------B|?-T-ME--o---oX--------o-ooX-o--M-M-X?---v
|-EB-B-B---oM--Xo-----T-XE?-|-?--EM---XM?-Eo-E?-?------o----?--BM-?--oM--B?---M-----BBM----X--|--X-------X-o---?TBB--?-X---------E-o--------B--X-X?--------M--X--XB----B---------XMMB--MM---X--X-------X
MB-----T----E-E-------|-----X---?o------BE------EB---?T--oE-T---o-----TTB-M------?-??--M-----XXB---------B--?-E-X----E---o-------o--o--o---E----B--Xoo-B?MM----?---M--M?M---MM???B--E-M---B---?-----??BX
T-E----XMBXX----------Xo--?B-----E------E-?MXo--M-EB-BX?B--?|B-Xo-----|XM---------?B--ME-X---?o--o--------?M-------B------X-o----BB-MM---X-----M-BEB?--BM--M-T-M-?-E--Bo--?--E--B---?-o----------EE-To-X
|-oX----------o-B-B---T-------X------------oM------B-----o--XT------o-Xo----XX---o--------B-?---E?--T?XT-----E--------E----M-BT-E----E----XM?E-T---M---T--X--X------?o-----T--B---?E--------o-?----E|--|
-?--T---o-----T-------|M----------------T-M-o-E--o--T-----B--|E----------B---?BM---X----T---------o-|--|---T--o-M------X--?M--|-----------B----|?-----T|---T--X------B-----|-T-TB-T--T-------------?X-o-
B-?-|-E-----?-|-------|-----------------|---T-------|--------|-B-?-------To-------------|-X---------|--|--T|-------------?----|-T-----TB-------|------||---|ToTo-----------|-|-|--|T-|------T--T------T?
m-T-|T--------|T----TT|------T----------|-T-|---T--T|T------T|-T----T----|T------------T|-----------|--|--||------T-----------|-|-----|--T-----|---TT-||---||-|-T---TT-----|-|-|T-||-|------|--|------|T
XXXXXXXXXXXXXXXXXXXXXXXXXXXXXXXXXXXXXXXXXXXXXXXXXXXXXXXXXXXXXXXXXXXXXXXXXXXXXXXXXXXXXXXXXXXXXXXXXXXXXXXXXXXXXXXXXXXXXXXXXXXXXXXXXXXXXXXXXXXXXXXXXXXXXXXXXXXXXXXXXXXXXXXXXXXXXXXXXXXXXXXXXXXXXXXXXXXXXXXX
