T----o?o-XE-X?----M?XM-o--o-?oX-Mo?X-X?MM----B-?XMoX?B-?-XE----o-o-M--XoX?B?-EXM-X-BXo-?--oX--M-o----o-X--B---E-M--X-------X--X-EE-M-MXo--E-?-o----Mo-BEMB-M?MXo?M-?BMB?-oXM-B-Eoo--X-M-----o??-X-E-o--E
|o----E--XBM--Eo-M--o---BEB-oMB-BEM--M-?-X-EE-MM-E-o-B--X--MoX?MEX-XE?--B--M----M-oMMM---oo-M--M-M-BM?----E--MM-BM--X--M?-X?-M--X----XMB?---M?-------XX--o--B-E-?-----MBB--?--M--M-o--BX--?M------BEE--?
|----?ME-Mo--oM----?oE--X------o-o--M-B-E-E--oM----o?o-X-ME----BBM--E-?-EX-?EE---Xo?X-E-X----Xo-oX---E-B------E--?---ME----X-EB--------B-B---?-----E-XXB-X--MM---oBE-M----E----MB---XX?---X--X-TE?-B--EM
T----?----?-X---X-EB-B-B-X----T---?--------?-M---o--B-BX-?X--B-M-XEE-M---??--X----EE---o-T?--oEE-----------E-?B-EMEo-Mo-XM-?----X--E-E-B-E-X---B--E--B-----M---o-Bo--------E-----?----?----B-BB|M?----?E
--B-------?---??-------X---o--|-?-B--X------M----B--Eo--M-T-T---------------M--EMX----EM-|--EM---------M-EBM------------B---B--E--XE--E-----ME-BXoE------o--EX--XE---o-Eo-B------B---o??---Xo--|-?----?T
B?--------B----o?M-?o---------X--?---?-EX-o?B---oE-------B|T|EX--??---?----B------?EE??o-|T--M--?----MBE--E-M--E---B-T--------T--BM-Bo-----X---?-o-o------X-E?--?MToE-X---oEo---B------M-X---MBX---B-o-B
B-----?-EX-X?-----E------o---?---B--oM------o---?--T--B---X|X?--B-EM-E---E-----ME-------XX|?----ME---M??-ME--E-MoEX-M|-EB-T---|oX--B-BMBB--XToTB----XM-M-oTE--oM-o|--XEo-oBo--T-?----------?----o-?-?--E
B-X?--B-MBMEM--o--B?XEo------MMM-?B-M-----o?EM-X?B-|--?o---X------B---B-----?X--E----BE---X?-?----XXo-o---M---o----o-X---X|---|-M-?---BE-XE-|-|------T----|--EoEM-|--BE----B--|M-EM-MBM-X-BB-----XB-E--v
oX-?B?-----M-----M-----XB-XT-?-B---B----?T?--------|E----EMoM-----o--X-BX----E----M---?--------------?B---------M-------o-X--BX-?--M-E---T-E|-X------|-o-?X---M--o|-EoBB?E--M-X------?-M-X---------X-o-B
?------B-M---E-E-BM--EMMB--|-?----ooo---M|?--o-E-?-X?---B--M-------E-?-M----B----X---o-BM----------MM--EBo-EM---E-----X-B----M-----B---MM|-o|?--E---?|-o-----T-X--X-----------MEM--oB-EEB?-B--X------?--
E??BX-B-E--EEB-Moo-------M-X----?---o?BB-XE--E----M-E--B-------ET----EEo--------------------M-o----?-o---?--B-E-oMBM---------E-----?-----Xo-Xo-------|?--MM--|-oX--M-?-?X-ME---o-X-?M-E-oB-BXB-------B-|
T-------T-B---------T-------M-----M-T-B-B--M----M---?--EM-------|---?---T-TT-----------?--T-XT-----------T----E-------??-T-----oXM-TBBX-M-TT-T-------X-X-----XT?--E-----?---?-M------?--B-----T-B--T---T
|--T----|-?T--T-----|-T---o--E------|------------------T-----o--X-------|-||T----T------T-|B-|-----------|---------B-----|-----T---|------||-|-----T--T--M----|----E--T-----T-T--------M--T---|----|--EE
|-T|----|--|--|--T--|-|-T-----T-----|----TT------T-----|--T---T-----T---|T|||TT--T-T--T-|-|--|-T-------T-|T--------T----T|-----|---|------||T|-----|--|T--T---|-------|-T---|-|---T-------|-T-|----|---E
m-||----|--|--|--|--|-|-|-----|-----|----||------|---?-|--|---|-----|---|||||||--|-|--|-|-|--|-|-------|-||--------|----||-----|---|------||||-----|--||--|---|-------|-|---|-|---|-------|-|-|----|---?
XXXXXXXXXXXXXXXXXXXXXXXXXXXXXXXXXXXXXXXXXXXXXXXXXXXXXXXXXXXXXXXXXXXXXXXXXXXXXXXXXXXXXXXXXXXXXXXXXXXXXXXXXXXXXXXXXXXXXXXXXXXXXXXXXXXXXXXXXXXXXXXXXXXXXXXXXXXXXXXXXXXXXXXXXXXXXXXXXXXXXXXXXXXXXXXXXXXXXXXX
