-oEM-M---MM-E--E-X--M--o-oooE?MMo-?-X-o--XM--MMB-XXo-----B-MMME---o-MMMMBE----?----X-oEXo-o-XXo-M-B---ME?-E-BE--MBME-?B--BM-E---EXo-?ME?---?---E-XMM-E--?---M---MoX-B-o?--MM-?E??---M-----M-----E--M-E-M
B--B?-E-M--EBEEM-BE?B-EEB-?---B-X--oEo--X-ooo---oB--BTB--?-----?--TX?-oE?-B-XM?MX--X--Mo-B----MMB---o-M?E?M---Xo-X-B----M--X-X-M?-MM-----XXM-----BX-----E--?-E-BX-?oX----E-o-M-?----X?BBoBX-M--TE-XXEB-X
?M-?M-oB----XM?----ME-EoMo-M--B--E-BB---X--E?-X-B---E|-?M?E-------|-oMo-o-XE-?-XXoo-EX-?---Bo---XM-B----XB-M-X?---oEB-X-oM--?oM--MM??-XM-?-MXX-BM--oE-XM-XE-----MTEMX-E--?MEXX--X------M?o-X-?-|EoMEB--|
oM-E-o--X-MMo?-XM--BE?-Bo-------M---E--o---oXE--E---E|-?-Mo?---E--|B-M-EX-M-------B----o----?Xo--o--X---M-X--------------XBMBo-----MB---EB--??--E----X-----o-----|----E-------M----M-TX-XBB--M-|---E---o
X------E-----?-B-------o---o----o--X-----X--?EM--o-X-X-M--o?------XE--o--T-M---------B--M------M------T----B-o--------BX-?-----?B---o-EE-BX--------oE--------B---X--?----o-X------B--|Bo---TX--XM---E--|
M--X-BM??---oooo-?o----?B-?-M-------EX--------E-BEE---Eo------?-----X----|-E------X-o-?-?--T---E-B----|X---M----Xo------?--MEX--Bo--?-?MoB----T-E--B-M--B--M-T-B-?----?---X--o---o-?-X-----|-M---E--E-ME
o--?-----X-X-------?--------E-----M---E-E---MM?--M---------X---?-B---B-M-|-E------MB-E--?--|--Eo--XX--|-----------E-----EE--BB--M?B------EM-BEXBM-?-----?Eo--|-o-?---EMXMBo-o--B---E--X----|-T---------|
o-----M-Bo?-TE--M-----M-----E-XX--------?------------M-M--E---oMT--BBo---|?--EM-X-Mo--Xo---|---o------X-oM-M----M--X-----o----?M-o-B-B?X-?-oM--------o?Mo-B?-|---o-o--E----X----B--B-------XM|X?--E----v
XB--B-EB-o--X--o----E---X?---------X--------?--?----E---E--X?---|----E---X------?ET---?----|------M-B--ET-M?--MXE--M-?-?-o----B-----------------B-?---M---TM-X-E--o-----M-E-----M-E-XXo-----o|-?----M---
EE-M-----------M--X?-----------M------X-B--?--B-o--------?------|--o----E------?--|MoB-----X----T-----o-X----?--E-----M-?----X-----M--M?-?E?------B---B-X-|--BE-----X----M----o-----------?E?X?-B-Bo----
o-M--------E-X--o--BX-?M--B--??o?B---o--B-----E--MoEB--X--M--EM-|---X---BoB-?---M-|-MoM--o-----oXT--E-E-Eo?-o---oBX-?X-E---M-B---M-----?--------XoE---??B-X-----X-----X--oM-B-?MoM---TE-E--o-----X--?-Mo
M-o-E-T----?-?--------?B---?-BE-?-------?---o-------------------X---o---oB-MB-----|----M--X---T--X-----X--T-------?-T-----E-T---ET----oo----o------?E--------M----TT?----E--?B--?--?-X---M?-B-?--T-?E--M
------|E----T----?--------?--------M-----oB------?--M-MT------?------X?-----------X--o--------|---B-T--E--|--X------|-M-----|--oT|--------T--TE---------?-------B-||-----M?--------BT-B---------M|---B-B
|-----|-----|----T---------T----------T------o---------|T------T---------BT--------------T-T--|-----|-o--T|-M-----T-|-------|--?||---oT---|--|-----------?---T----||--------M-------|------------|-----?
mTT--T|-----|T---|-TT------|------T---|----T---------T-||------|----------|--------------|-|--|----T|----||-------|-|-------|---||----|---|-T|--------------T|----||----T----T--T---|-------T----|-T----
XXXXXXXXXXXXXXXXXXXXXXXXXXXXXXXXXXXXXXXXXXXXXXXXXXXXXXXXXXXXXXXXXXXXXXXXXXXXXXXXXXXXXXXXXXXXXXXXXXXXXXXXXXXXXXXXXXXXXXXXXXXXXXXXXXXXXXXXXXXXXXXXXXXXXXXXXXXXXXXXXXXXXXXXXXXXXXXXXXXXXXXXXXXXXXXXXXXXXXXX
