-BX?EBE-E-BE----o-M-XX--B?E-Xo-Boo-?M-Bo-?o-BM-EX-oEMMBoE?-B?B---M-----?-BE--?-?B--EE-M-B-BoE?-?BMoXM--BBM-----oX-?-X--BE?---MEB?E-MEBE-E--EBMXE-BX?-----MMoMoB----Xo?---M--o-XMEo?X?MX-----B?-B--?X-MMo
|oMXB-X?-Xo-B-oB-M-XM--oo-??M-X----MXE?EB--BX-E--Xo-o--?X-Bo-XBXX--X?--o--o?oEM--X---E-oMMMMEXM-B-BX-?B-XM----B--XM--B-oX---??-EX?Eo---o------XE--o-EooB--E---o-BX-M-o-B?--?o---E-o-?BX-MME--?ME???-XXoT
--oM--B-BBoB-XE?oo-o-E--BX-MEEXXoXoB?E-XE---BM-?B-EoX?MoE-?-BBMo--XM-M--BB--?-oMEM--E?-E?oo-E-oX-----?XoMMoEM?X----MEo-BM-M--??EMEX--XBMX-XoEXB---B-oM-ME-B?--BB---B-MEM----?-X-EM-?EX---Xo-?-oE-E?E-M?|
T--o??---MoM-oX-EoB--MB-E---B-??EX-oo----M-E-?Xo--B?BXX-XBoB?B?-o-MXBB--?E-?EB-BMB-E-EXM-o-E--XE?-B--?--oEX--o---M?X----M--M-?oX-M-o-M--?-?-MM-E--BBoB-EME----XBE-BB-BoM-B-B---?X-o-MEE?M--?-EE-o-----XM
T-M--?X---X---M-----?M-oBoXXX??EoBEMMXXEB-o--E--?EMXEX-?-oM-XEBBB-----M--MoX-XMM-EBBo-ooMM?EEEEM-------EoM--?-X?--EEMMMB-X-BM-M?-B--M-EX--B-MoMo?-o---?M--X--BXMB--BBooM-EX-EXEoBB?-Bo-oMXMo?oooM--?B-E|
MEo--EME?-X-BX-MXXM-EMBB?X-EM-M-E?--M-MEMBE-Mo-E-?-o-B-BoBBoB--XE?EXX-M-?EBEM-----EE-Eo---BEEEB?E-Eo-XEo-M?X-o--M--M?o-E-X-oBoME-EBM-B-X------M-EBXM?-XB??M-BEMXE?XB-Mo-o-X???XM?-o?-XX??oME-BXo-MX-?oMM
?o-EXM--B?o-?Xo--BEoMM-MXB-M-?EBBoBXXE-B?M-MBBMo-BMo?-X------MXM?E----oB--ooB-B?o-M----oo-?EE-X--B---XMX--XEBBo-----?X-?--BE-BX-EX--MBM-E--?-MBM--oME?-Xo?--E-BoB--Mo-XB-E--MMoE-EBoo---oB-?-?----XBX--T
?X?o--XBEXBMEM---oE----XMo--X-X----o?Mo-?X-??---oE-B-B--X--o?-?-oX?MXE-XB---MBM-?Bo----E-BE-EXX-oB-BMB-B--EX-oB--Bo-B---E-MoBE---BM-X-B-oXE?---X?B--o-o----E?B---E?--M--EEo-M---?oB---X-Mo---XMEX-B?-EXv
?-?--X?-B-?-?--E-XXM?-M--o-o-E---oM?-o-EB---M-E---------MB-?BoXXEB--B-X-?-M-oEoEX-EB-E---?--BBEE-XMXM?EB-B--?-----XB-?E-MM--MMEBE?MMX?-X-B-?---EE----MoM-MM-E?-M--X---MMoX-?EBEXooMB---XX--M-o---EMo-?-B
EBEEM-oo-EB----ME--XX---M-MXMM----EX---?X-B--B--B---E-Xo?-?MXEo---?-?X--BM--?-EoB-BB---Bo-M--B-o--E?M-MEEM-MX--X-oB--M----XE-X-X-?-EX-XBBEX-o--XMEE-BMXo--o--EX-?oX??B---o-MXBE-B?MB---?oME-E--oE-ooXX-B
?-?oE??B-X-?--?oE-MB--XXo---oM?XoM--XXM-E-BoM?--X-X?--MBEXB-?o-MBoXoXE--M-E?-M?-XX--BE--E?M??BXM-X?-X-MEoBo--BM-B-EXBXEoXoBM-XMo-?-X-o?--B---M-X-?-----??-E-EE?-BXo---?M?EE-E-BMMMoo--?-BM?EXX--E-XX-MEB
|-B--o--E-EBEB?----o-B-XEM-XE-?--?oXM----oX--B--BooBo--X-M?-XB--B-XE-M-M-ooBMo??X-MX-E-MX-?MX-?oE--B-?X-X--MX?XM?M?B-XB-M?--Mo--oM?oMoB---oMMM---?-MM-B?X-E-oXoXB--ME-B---XB?XM-?-M-?-B?--MoM-E--oM?o---
??-o-BXXo-XM---E-o?----?--?-Xo?MEE?XXB-o--B-MEXX--XEB-BoXMM?Bo---?oo-oEXM--XE?-E----o-X--?XX--EMBBMBX---B--?Xo--?oo-BMEo-?XXEXM??X-?--o-MXMoX-XM?EXo?o-M?o?BMXB--BoM?-E-M-----?---EoE---Mo---??--Bo--o?T
MoBB-----E???-XE-EXME-E-BXXE-EB--oo?M?EXM?E-o?MM-BEM-M-XMo-EXEE-oB--M-E-XoB-E-?Xo-E-EEMoMEME-E-B-E-M-o-MXM-XE--M-o----M?B?E---?EE-?--XoX--Mo?Bo?X---MXE---X-MEB--E-MXX-MMM-B-??EoM-EXME--M?-?-X-o-----oX
mB-M--XoX-?oEB-B?----XoM-?M-X-M---Xo--B?oE-----?-X-M--E--?-XE-MX--M-MMo--BM--oX?-M?B--?Mo-E--B-MXE-X-----o-?MEX?BBEo-MoBoBB?XM------B?o--X-XMXXXM-??M?M-Mo--XM--BMBo-B---oBM-?B-EE-oEB-MX-??-EM??-??-MBB
XXXXXXXXXXXXXXXXXXXXXXXXXXXXXXXXXXXXXXXXXXXXXXXXXXXXXXXXXXXXXXXXXXXXXXXXXXXXXXXXXXXXXXXXXXXXXXXXXXXXXXXXXXXXXXXXXXXXXXXXXXXXXXXXXXXXXXXXXXXXXXXXXXXXXXXXXXXXXXXXXXXXXXXXXXXXXXXXXXXXXXXXXXXXXXXXXXXXXXXX
