-----X-----------------------X---------------X-----------------------M---------------------B---------------XX-----------------X------------------EX-----------------------X-----------------------------
----------------------------------------X---Xo----------------------------------------------B------------------------B--------B--------------------------------------------------------------------X----
-B-M-----------------------------------X---B--B---------------------X---E-o------------------------------------------------?----------B--------------------------------E-XE---M---M----------------X----
---------------------B------------------------------------------X?---X-------------------M-----------------------------------------------M--------------------------------------------------------------
--------B------------------B-------------------------------------------------X-----------?------------------------------------------------------------------------------------B-------------------------
-------------------------------B------------------------------------------------?-----------------------------------------------------------------------------M----------------B---------------?X--X----
-----------------------M---------------------B--------------------------B---------------------M-------------E---------------------------------------------------------------------------------------MX--
--------------------------------------------------E----------------------M---------o----------------------X---M--------------------------------------------o---E---------M----?------------------------v
---------------------B-----------------------------------------------------------------------------------------------------------B--------------------------E------------------------------------------f
-------------------B------------------------------------------------------B--------------------------------------------------------------------------------X--B----X-----------------------------------f
----T--------------o------------------------M-----------------------------------------?-----------------------?-------------------------------------------?------------------------X-------------------f
----|--------------------------------------------------------------------------E-------------------------------------X---------------------------------------------------------?-T---------------------f
----|------------------B---------------------------------------------------------B-----?---TX-----------------------------------------B---------------T----B-------------------?-|---------------------f
----|--------------------------------X----------X-----------------------------------------XX----------------------------------------------------------|------MX------------------|---------------------f
m---X-X-X---X-----o-------------X-----XX-XX--X-X----X--------X-----------?X----XX---X-----------XX---XX----X-----------------EX---------------X-------X------------X-------------X---XXX-----?----X----f
XXXXXXXXXXXXXXXXXXXXXXXXXXXXXXXXXXXXXXXXXXXXXXXXXXXXXXXXXXXXXXXXXXXXXXXXXXXXXXXXXXXXXXXXXXXXXXXXXXXXXXXXXXXXXXXXXXXXXXXXXXXXXXXXXXXXXXXXXXXXXXXXXXXXXXXXXXXXXXXXXXXXXXXXXXXXXXXXXXXXXXXXXXXXXXXXXXXXXXXX
