-----------------------------------------------------------------------------X--------------------------------B---------------------X---E------------------E-----------?------------E-------------------
----M------------------o-?----------------------------------------------------------------------------------------------?---B--------------X-------E------------M--------X-E------------------------E---
-----------M-----?----------------------------------------------------------------------------------M---------------------B-----------------o--------------------------------X---X----------------------
--------------------------------------------------------------------------?------------------X--------------------------------------------------M---------------------------B---------------------------
--B--------M------------------------B-----------------------------------------------M-----o----------------------------------------M------M--------M-----------------------E----------------------------
------------------------------X----------------------------------o--E----------------------------o----------B----------------------------------------------------------------------------------------X--
-----------------------------E------------M------------E------E---E---------X------------------------------BM---X---------------------------------------T----------E------------------------------------
--------------------------------------B----------------------o--------------E------------M----B-----E-----------?-------------o-----?-------------------|---BX----------------------------------------Bv
----------------M----------M-----------------------------------------------------------?-----------------------------------B----------------------------|----------------------------------------------f
----------------------------X-----------------------------------------X-----------------------o----------------------------------------------M---------oX-T--------------------------------------------f
-E-------------------------B-----E-----------------------------------------------o-------------X--?---------------------------------------?---------------|--------B-------?----------------oX--o------f
--------------------------------------------------------------------------------------------------------------------M-------------------------------------X-B----E--------o----------M-----------------f
---------------------------------------------------o--------------T--------------------------------------------------ET--------------------------------X---M----------------------?-------------M------f
------------------?-----------------------------------------------|---------------------M-----------B-----------------|----X-----------------------------------------------------------------------X---f
m-?----X-B---------X---X-X-X--------------------X----X-XXXX-X---XXX--------X-XX------------------X------------------X-X----------------XX---------------------X--?-X----M-----X---------------X---o-X--f
XXXXXXXXXXXXXXXXXXXXXXXXXXXXXXXXXXXXXXXXXXXXXXXXXXXXXXXXXXXXXXXXXXXXXXXXXXXXXXXXXXXXXXXXXXXXXXXXXXXXXXXXXXXXXXXXXXXXXXXXXXXXXXXXXXXXXXXXXXXXXXXXXXXXXXXXXXXXXXXXXXXXXXXXXXXXXXXXXXXXXXXXXXXXXXXXXXXXXXXX
