-Bo-B?E-???ME-B-oXM-E-B-XE---??-E-BoEM-o--Mo-B-T?MM--M--?E-ME-?X-MBX-ooM--EEX?--?E?oE--MXM-EE?-o--E-M-EMMo--MMB--X-??---Xo-oEEXXME--o-----?X---Mo-MMMo---BEX-E-?EMMoo?M-?o--o----XM---XB-E-M---B-oX--Boo
T-o--X-X-BB--o-oB-B-E-?--o-EEB-M--XXBoB-o----BX|E-X?E-MBE?---EE-E-?MX-------B-M--M-E--M?E-X-XBE-EE-?Eo----M--?-?M--oXX-o-E--M--oM-E--XE-EMEE---------oBE--XB--E-XXo?-X-B---X-o-MX----------?-M-Eo------E
E--?EXo--Bo---TB-B---M-Xo------B-?B--B----Xo-M-|----oMEo-XM-----oo--BB------MX--oM-MX-EXo-EM--E-E--B-----B-Mo-B-XX------MM----?--T-B--?---E-E-EB---M-Xo---MX-------Eo---BB--?E----B--E--?T-BB-B-o-M-X-E-
B---E----o-Xo-|----XB?E----o-M-ET--E-X-o---E---|-?-X-Mo---XM-oX-E-------X---M---oE-B--M-o-?---Eo--B---T------BX??--o----Bo--o---M|----EB-o-EX-----M--XX--Mo?M--E--E-----Bo-----T-BMB-----|-X-----X--M--E
M------E?-XB--|MMo--?oB--------?|--o-------?-M-X----X--B-?B--??--?-T-----E-B-M-oB--??--B?Xo----o--M-M-|----XEBB---T---B---X----T?X--MB-----------EBEM-----?--o-----B------M-ME-|o--E--?--|X?X----oX-BT-|
?------M---?oTX--M---X----B----T|---To--B-o-E----EBE-B--MM-MM?-TME?|o--M-------X----M--M------M-B??M--|------??EE-|--B?---E----|E-B?--B-EM-B-oM--M-----?--?-oE-XX-?----o-------X--E--BEMMX---M-------|-X
E----?-o---o-|-B-----Mo--o-----||---|--B---EoB-B--?-------M-X--|--?XEo---B-?-?-?----BXB---M-------o--TX?-?-?--ME-BX-?-B----o-EMX---?--M--M--?Eo-----?XE---------E-E----o-o-EoM-B--BBM--M--?o---M---?-|XT
|-XB--------EXB--MXM---B---B---XXo-MX-?-B----M-----?---B-M-----X--B---B-------B-?E-o-----o--E---M-B--|B---X-T----EE-----------o--B-X----------MXE-ME-B?--E----?-E---XX--?E--E--EB---o??---M--E-?M-X-BXTv
B-----B-B-o------?ME----To-o---------T----M-BB--------------o-----E--X------X-MoE----o---------E-E--X|M--?--|---EE-?M?------X--T---X-------EB--?BM--BE----------o---o-?-EM--------o---o------E---?----|X
XE---BE----------M?--B-M|o-M-X-?-T---|--XB------X------M-TXBBEB-BMo-X--?-------E--B?-MTB--?o-----EBE-X-?----XT--ME-BoBX--MM---X|?--M-X--X-?----MB-----M---oo----------M---oX?-?-----E--MEo?-----EE--E-|E
--E-----E?-?-XBE-?----MXX-?XX--?-|--E|--------B-MM----M-?|MB?-EEE-B-M-B---BX---E?----?|o---X--X-BE---?EE-MB??|-E-B--EToX----M--X-----B---?-B---------?--X---EX----o--M--M--M?M--X?o--B-?--B-B--B-Xo---XM
E----o--E-o--B-T-oT-M------------X---XB--?-M--T--T-------X----M--o-----------B--M-TM--X---B---B--TM-o--TT----XT-MB---|-Mo--TT?--TT-E---M--XTTMXE?T---M--o---------ET--------------M----T-T-----T-------|
?-T------------|--|B-B---E--------T-------T---|--|-----B-------B-------T-----B--T-|?--o?-T-o-----|--M--||-----|------XT---E||o--||-T-----B-||TX--|-------E----M----|----------------T--|-|-----|--?----|
|-|---------T--|--|T-----TT-------|-------|---|--|-----T--T-------T--T-|------T-|T|------|-T-----|-X---||-T---|----T--|-T--||---||-|-------|||-TT|--T----------T---|-TTT----TT---T--|-T|-|-T---|--T----?
m-|---------|--|--||-----||-------|-------|---|--|-----|--|-------|--|-|------|-|||------|-|-----|-----||-|---|----|--|-|--||---||-|-------|||-|||--|----------|---|-|||----||---|--|-||-|-|---|--|----E
XXXXXXXXXXXXXXXXXXXXXXXXXXXXXXXXXXXXXXXXXXXXXXXXXXXXXXXXXXXXXXXXXXXXXXXXXXXXXXXXXXXXXXXXXXXXXXXXXXXXXXXXXXXXXXXXXXXXXXXXXXXXXXXXXXXXXXXXXXXXXXXXXXXXXXXXXXXXXXXXXXXXXXXXXXXXXXXXXXXXXXXXXXXXXXXXXXXXXXXX
