------------------------------------------------------------o------------------------------------------------------------------?-------------------X-----------------X---------X------------------------
----E------o-------------------------------------M----------------------------------------------------------------------------B------o------------------------------------------------------------------
-------M-------------------B-------------------------------------------------------------------------------E-----------------------T-------M--------------------?----------------------------------E----
----------M------M--------------------------------------------E----?-------------XX----------------------------------B------M------|----------------------------------------------o---------------------
---------------------------------------------------------------B-------------------------------------------X-----------------B-----X-------------------------E----------B-------------------------M-----
---------B------------------XE----------------------------------------------------------------------------------------------------E----------------------------------------------------------------X----
-------------------------------------------------------------------------------------------------B---------------------?-----B--------------------------------------------------------------------------
-----------------------------------M------------------------------B-------?-------------------------?------------------?-o-------------------------------------------X-----------------------------X---v
-------------------------------o--------------------------E--------------------------------------o---------X------?--------------------?-------------------X----------o--------------------------------f
--------------T-------------------------------------------------------------------------------------------------------?-------B---------------------------------------E-------------?------------------f
--------XE----X-EM-----------?---------E----EB-------E-----------?---------E--------------------------------------?-----------------o------------B-------------------B-------X---------------------X-X-f
---------------B--------------------------------------------------------------------------------------?--------------------------------------------------------B---------------------------------------f
-----------------------------------------------E-------------------------------------------------------------------------------------------------------?-----------------B-----------------------------f
-----------B--------------------------------------------------------------------------------------X------------------------------------------------------?------------------------------------------X--f
m----B-------X------------X--X-------------B----XX-----?---------------X----------X--------X-----E-X--------X--------------o--X--X-----X----------B---X-M-------------X-o-B-------oX--X--X-o-----------f
XXXXXXXXXXXXXXXXXXXXXXXXXXXXXXXXXXXXXXXXXXXXXXXXXXXXXXXXXXXXXXXXXXXXXXXXXXXXXXXXXXXXXXXXXXXXXXXXXXXXXXXXXXXXXXXXXXXXXXXXXXXXXXXXXXXXXXXXXXXXXXXXXXXXXXXXXXXXXXXXXXXXXXXXXXXXXXXXXXXXXXXXXXXXXXXXXXXXXXXX
