--XM--EM--M?---B--o?B--MX-MMEX??--MB-oo?M-XEE--M--Bo?BE?-M?-BEM-?---?M-B-??--oXX?-B-BX-BBB-?E--XB-E---E-o-M-o-X---oX--MEBBMEMX?EE??---B-?Eo---?M--?X---MEoo-BoEMB?XoXo--M-X-B-E-??-X-X--EX?-M-EEoo?-oX--
-M-oEB-XB---X---M--MXoo----B---XE--o?X?EMMMo-M-MEB----B----EBEX-X-XoXBM-MEM?M---M-E-?X---B-BE-X--oo?B?XE--X?ooM?E---??-oM--E-oE-M?EX-X?--o--o-XE----o-X-??oo-BB-----BMMo-X---MM-XE?-oE-oX-?EE---EM--o---
--M--M-B?EB?E--M-EEBBo-o---EXXXMM-XTB-M?E-?o------XM---oMMoXEM---X-E-MB-X-?--MM----B-?B--XoBo-M-EEoMB-B---o--Bo?X-EXE-M?Xo?-MMEE-E---MME--MME-BM?X-M--Eo?--?-?B-----o---??E---BE-?-E-B?M---Eo?EE---M----
-X---X-oM---M---XM-o-------?-EMoo--|M-o--B-oM----M------B-X-M-B-o----X--??-M--E-EX---B-?--E-M-M-X-?o?Eo-M--BXB--Eo--EoE--Mo-----M-B-E-o-M---?--M-----o--E---o-----oMM------M--?---o-ME--EE--E------TB?T-
-??B-B--B-----MXB---X-MX--X----o-?-XEE-------o--------X----o----o-E-M--oMB---oB--E-XB--?----B----X?--B----B-B---------?B--?---E?--?-BB---EB----M--o-----B--MB-EX-B-E-EBM-------B------E--?--BM-oB--|--|-
--o----B--?--?-?---o-M---Bo---??---B-------X-MEE-B---BE--?-------M-XXX----BXM?MME--E------B--M------T-------?-E------E-B-B-------X-E-MX--?-?-BXo-o-M--?-MX-MMoB-oB-o--oBM---X-?--EE----o--o--MBo-o-|oB|-
-MM-X-BEB----?----M?--o---E-----E-----o-M--B-B----?M---E--o-----XMo-------o--??-?M-B--E-TE--o---BB--XM-?EoX--MMB--------ME---E----?---------M--?oo-o---X?BM---B---E--B?M--?-B-o--E-Eoo-oBBo--E-----X--|-
--E-M-?--E--B-----??-B--X--??----------EM?---?------o-?----E-MXX-MB-X-----?-B--BBo------|-B-M--o-?--BBB---BM---------?-EM---?--E-E-----E--------?---M--M--B-M-?-E--o-oB----M---E---o-------B-EM??B-??-Xv
-----o---oXB----B--?--XX-BB-o-----E----B?E---M-------E-?---?--M?-M---E--E----?---o--M-?XXoo---M-B-MoM-------E------X-o-----ME--BX----X--?-o--------B----BB----?--X?--MTEoE------M?------X-??----M---E--f
--E-B----E--M----X---?--X?---o-EE---BB--------M----EE-o-Eo---o?MB-EMB?B----oE---------B-M--------EM-----X--------X-?o-MB---???--o?o-E-M-o----M-E---oXo----o-o--BX-?---X------EX---E-------------E--o-M-f
------B------X-o-?-E-BE?-----E----o---BX-BM---B--E---M---------M?--?----E?-----X--XX---M----X--EBB-?E-?-o-?---X----o----o--M---X--?--E-M?M-M--E---E-?-E--B--o--B----BB-----M---M-Mo--?---XB---EXMM---M-f
--o--ME-M-BMEE?E-oM?-o---M----M----X----?M-----------------B--?-B-B-?-X-?---M?-MM-ME---MM?-E----o-----B?---B?--MBB-?------B-----oBME--?-B?----E-X---B-----?E---B----E-E---o?E?--o----o-----BX?----oBEE-f
----X-MoEE---?------X?-?---Xo-B--?Mo?X---------X-?-E-----?BE?-o-M-E--X-?o-----M---BB--?----?-----??--M?-o-M--?--Mo-E?---o-MM---M--M-----B--E-Mo-o---?-M--XB--M--o-o--------oB-----X?o--?-o-B-BM--MMo---f
-M---EMM-EM-?---------B-BBE--XBo-M-?--X-?---X--o-E-o------oM--------?----o---B--E------B-oo---?--------?--?BEB-E--X---oB--B?X?M--E--?B??--X-E-------EE-B--o--M-?-M-oMB--E--?------o--------E---M-?-E-o-f
mM-XX--XX--M--EX--EE-B--?-BX-M--?-B?XX-oEB-EBB--?-E--oo---?MXX-M?X-B-BB?-?--MooMMBM-EB-BB--B-X------o?X-?X-BE-oEMMB-Bo--o-o-Eo-B--?EME?M-XB-BX---??X-?-M?--XEME-E?XBB?-B-X--??B--B?o-EoMB--o?B---?B--B-f
XXXXXXXXXXXXXXXXXXXXXXXXXXXXXXXXXXXXXXXXXXXXXXXXXXXXXXXXXXXXXXXXXXXXXXXXXXXXXXXXXXXXXXXXXXXXXXXXXXXXXXXXXXXXXXXXXXXXXXXXXXXXXXXXXXXXXXXXXXXXXXXXXXXXXXXXXXXXXXXXXXXXXXXXXXXXXXXXXXXXXXXXXXXXXXXXXXXXXXXX
