B?oXoo-?-?E?BM-B-B-o?-MMXXEE--E-------X-EE?---M?X-XX---M-----MXE?---Xo?--E-?-BM--EM-MXoB-XBo-E--ooEBXB-X?-Eo?M--?-o?-ME-oEMM--o---o--E-Xo-M?EoM--M-oM----E?---oB-X--MBE-B--EX-X-?E?B---?-o-E-oo-o?M?MEoT
-B-E----?B-?-EBBBBBXE-B-MoMMBX-oMBBB?E-XB--B?XE--?--E--MX-XX-EoBEEBXE---E--oM---M?XoM-X----EM----X----B--oo-MM?X-E??-XBB-oX-XooXXo----XEXo--X---MB?-----BE?oE---BME-?-XM-X--EEMEE--B---XX-X-M---M--X?EXB
BT--E-?X-MM-MBXo-?o-XE-BM-X-E-XB-o-?-?-----XX-?EMoX-M--?-?-XoEB---oB?oX-E---XM-Eo?------BM----?-o-EB?-BoEEoM-?-EMBX-EM-?E------B?--M-B---?oEM?B-Eo--X-XoM--?XM-----X?E?---MBXM--o-?-oMXM?---B---o?E-o-oB
-|o-----B--B--MM---?B?--M-X-o--?XoM----------X----oX--?---M---X-----T-B----E-?TB?-M?--EE----oB--M--XM-E-M-X-------?M-MB---M-?-M--B-BX-?----B-B--B---o----BM----oB------o--E-X----Bo----o-----M--?oX-X---
M|-o----M----oE?------?MMXMEME--------X---EBoEo--E--o--M-X-----B-XEXX--?----M-|-MM---Mo-BM-M-E-E-------M---B--E-------M?-----ME--ME----X----E----M-o-?-------Xo------?--X--------------o---X---EM?-----M
?X-B---T----TM-E-----M-o-oT--?---oB-----X-Eo---X?o----ToB-X--B----?----oMX-?-MX---?o---MTM---?MB?EE--??M---E-B-----o--?o--BEX--oM--o------B------BT--o-X-B---?-X-XE---B-------X-X---oX--M-X---M-?------E
o--?---|--?-|--??o-X-B--B-X---??-B--X-X-E-EE--o--MXo-?X---------------XMM--?--B--------B|o-------B-X---M--B--M----------M----?M-o-X----?--B-----M-X--?--MBE--M?M-E-X-------Bo--B---B?--X----XEE--?o--o-X
MX?-BM-X---MX-o?-----oM-?X---MEo-M---o---E--X-E-X---?---EM----X-o-----E---?--?--XMXo-?--|--XE-----?-MM---oM----MEM-BB--XM----M----------EBM-EX-o----------B---?--M--M-o-X-------BE-T----o--E----o---MBXv
?-----XM-E----MoMo--o-B-M?X-MoE-o--?X?E----X------E-------E?o--E---X----B-o-M-?E---MM?--|-X-----o----o---BMo-B-B--o---------E--?---X---B----M--o------X-E---TM---BXX-------?X-?--BM|-?o---ooX--X---E-o--
|---T-M------X-M-----??--------X--?M----X--o-XX--M-BX-o---EMMX----BM-B-------o---oB-----XB-o?-----E--B---E-E--B-M----M---T-T-o-B?------o-?-B----B-----M--X--|MBE----oBB---X?-?-B-E-|--MBXX---?----B---M?
Bo--|B-ME?--E?XB--?---B-Mo-B-X--o------o-?-----?o------o------EE-o-M--E-E-E?B--X---X---MM?--M--XM--XX-----XBMMoB-?o--E-MBXoX--o---B---XBo--BX------X--E-E-XB|----B-o------MM-M--Bo-|X--?-?----??-BB--?-X
?-B-X-M----B?-----o-----E-E---B-E-X-X--E---XX-------oB--B-E--M---?X-XM----------------?-MM------E--M--Mo----------B----T?B-B----Xo------------o?o---X----X-BX---?o--------oM-EB-o--X--B-?-?-----B--o--ME
TMM-M-E?-oM--MB---o----o-----------------?------Xo-E-------?--MBE------o-------B-EM-E----?X---X--TB----------B-E-X-----|-E?-o--?--?-M?BoB----o--M-E--------B---X-?-------X----M--?-BEBMM?E-o-------M-T--
?--M-EE-?-----BB-M---M----E?---B---o-E--?-XX--?ME-oE----MXoTo--ET---E---oM--M--oE---B-X----?--M--X------X--E------?EE--|----?--Bo----B--?XEM-E-T---------XM----o?B--o---?----?--ME----o-T--------??-XX-?
m----T-------T----------T--------------------TT------------|----|---------T--------------------------------------------|-----------------------|-T--T-----T---------------------T-------|-T------------B
XXXXXXXXXXXXXXXXXXXXXXXXXXXXXXXXXXXXXXXXXXXXXXXXXXXXXXXXXXXXXXXXXXXXXXXXXXXXXXXXXXXXXXXXXXXXXXXXXXXXXXXXXXXXXXXXXXXXXXXXXXXXXXXXXXXXXXXXXXXXXXXXXXXXXXXXXXXXXXXXXXXXXXXXXXXXXXXXXXXXXXXXXXXXXXXXXXXXXXXX
