EXEX-BB-oXMBE-XEXM-o-?B-o?EX-?---oEBB---B?--B?XB?BE--BMEBE--o-?--E-----M---oB-EMMXo-E?X?EXEB-?BBMXo?-BB--MMEM-EE-oEo??Mo-?B--BXMEBXM-E-o-MM-?E-?X----------?-oMB-EoM?-o--o-B-X-M-X-MB---oEEE-----?--Eooo
TB-E-o-EM-XEX--BBB---?--BE-M?-X-MM-M-XX--E--?-?-E-ooXM-XEE-MB-?XX-M-MM--EXoXX---M--M?E-?--Xo-EB-EB-?-BMM--o-B---XXMEXo?BEE-?-B?-MM?--BBBB---X-MXMBo-o---B?-B-X-EMM?o---?XMM-EXooBEBXB?-?---Mo?M-?BEX-M-?
X---E----X---M-oM-XE??-oo-MM?--Eo--oo?MBEo-B------??-?--?oB----o---E--E-?-?--M??X-oB?-o--?E-o--?E-XB-X---X---X--X--E--?o-?X-E-X?EEoo--B--M--BE---oE-o--XMMEoM------o-?M-?B--o---B?M-B---M--?XX?----E-?XB
|---M---M---B------X------T?--EEE-M---EB-------?ME------o------M-E--E---M--EX-X-B-XE-o--?B-oEME--B----XMB----X--M---M-M--Bo---Eo?---M--B-o--XB--o-?X----B--B-XXXE------B--MoE-------E----?-Xo-E-------Eo
o-----?-?----X-MX?B----BMEX---E-----EB?--E---E-----X?---?X----?o---MBX--M------B-oB-------oM---?--B--o---o-M--EB-M------M--o--M--?----??o--?--E-o---------E--?-MB-E---B--B-------o------------?---E-?--B
|E--E?-?---oE----?--M-B-MB---Bo----EM-E---EXEoM------?E-EE-E---oMBM--M---?-XX-------???E--E--M--X-M-oE------M-----?E--MBo-o??-E---o-------M-oBE----------X---o--o-?--------?---------E?B---M--E--B--?-MT
o---BB----M---B-M--------E-------X----------?--MEB-------oB-E--B----o-B---M--M-X-oM?-M------B-M------------?----XE-MEEo--B-E-X------o-M-----B-M-B-?E-----?----oo?X--MB------?o?----------EM----oXoE-BME-
|-E-MEoo-X-o---X--o-?M----E-------E---BEE-EE----o----oo-Moo-o---oM-X------------B--Mo-Mo-?------BBMXB-----B-----M----B-?E?---?-----X------BB-oMB-?--B-?XT-----E--o--?--BoEE---B--------------B-ME------v
XX-E--B---B-MM-ET-EE-Bo-------??-X--M-B-EBM?------?---E----M---E-o-M?EMXE-?--------EM---------o-ooE-oX--M-oE----B-----------X?------?X-X-------?--------X--X--?B----E-----M--oE-------B-----BoX-?o---BBM
M?B---E-B-EE----|-o------M---E----?-o-E--B----MM-o----BEB---?----o--M-M-------X-----------MX----M--?-----Xo--XB---?E---M--?X-?-Moo-?--oM-E-E?--------T--oXMMB------XE-----o?--?---E------M-E-----------o
B-oMXX?--??B--o-|-o-----B----E---M-----BM----M?-??B--oBM-E-B--??M---M?-B-------Bo--M-------o-----X--XX?MM-------X---M--?X-B-B-----BoM-----------B-EE-X?B?-M-ooE----o--MXMEM--B-B-B-------E----X--o-Mo-BM
o-M-----E-------X-Bo-oMX?-B-----oEX-EoET--MME-E-M---MMo-Bo--?o--o-----E--XB?B-M-M-EE-B?-----E---E-B---TE-M---oEo---o-oXB--?--XE-?E-----M-E?----------E--B-TXo?------B----o?--------X----BBE--E--BB----T|
E---E--o---??----EBMT?-o--B--MM--o-X---|---M--E--M---?--B---E------EEX--?-B-o--Bo------B---oM--BTTM-X-|---?-E?----M----?-ooo----?--------B-E-EEX-?----MX--|o--------M-----E---X-X--M----o---E----Eo--?|o
TB--?-----o-BE-----E|---o---E---o-?----|o------M-----T-TM-----E-M-?---oE-M-o---EE-E--o----------||---o|---o-?--B---To-T-T-o-?XBo------o--M?-?B----EE-?----|M--M-----TB----M--BMoo-TB-----T-E--?----To-|M
m-------------T-----|T-----------------|-----------T-|-|-----------T-T-----------T---------T----||---T|------------|--|-|--------------T-----------------T|------T--|------T------|------|---------|--|B
XXXXXXXXXXXXXXXXXXXXXXXXXXXXXXXXXXXXXXXXXXXXXXXXXXXXXXXXXXXXXXXXXXXXXXXXXXXXXXXXXXXXXXXXXXXXXXXXXXXXXXXXXXXXXXXXXXXXXXXXXXXXXXXXXXXXXXXXXXXXXXXXXXXXXXXXXXXXXXXXXXXXXXXXXXXXXXXXXXXXXXXXXXXXXXXXXXXXXXXX
