-----------XX--------------X--------------B-oX----------------------B-------------------------------------------------------------------B--------------X-X---------------X------------------------------
-----------------------------------------------------------M-------------------------------X-------------E---------------------------------------T-----Xo-----------------------------------------------
----------------B----------------------------?------------------------------M-------------------------------------?--------B-?-------------------|-----X------------------------------------------------
------------------X------------?-------------E------------------------------M-------------------E------------------------------------------------|--------------T-----o----------------------?---?------
-----------------X--------------------------------E-------o---------------?------------BX------------------------------E-------------------------X-------o------X-------------?---------------------XX--
---------?-------?-------------------------------------------------------------------------------------------------------------------------------------?------------------------------------------------
------------B---B-o----------------------------------B-------------------------------------o----------------EE--------------X--------------------------------------------------E------------------------
---------o------------------o------o----------------E--------------XX----E------------Mo-------------------------------------X---------------------------------------------------------o------------B--v
----------------------------------------------X----------------B-------?-----------------------------------------------------------------------------?----------------------B---------------MMX--------f
---------------------o---------X---------------B----o---------------------------------------------------?------------------------E---------------------------------------------------------------------f
---------------B---------------M---------------------------------------------------------------B---------------B---------------------------------o----------?------------------------------------------f
--M-------M----B----------------------------?------------------------------E---------E-----------------M--------------------------------X?-------------------X------o----------------------------------f
-------------------B--------------------------------------------------M------M------------------------------------?-o-------------------------------o--------------------X-----------------------------f
-------------------------------?-------------------------------------------------------o---------------------------------M--------------------------------------X---------T-X-------------B------------f
m--------XM-----X---B-------------X---B-------XX--------------X-------o-X--X----------X------------?--XB-----X-------------X----X--XX--------------X-XX---X---------------X-E---M----------X-?-----?---f
XXXXXXXXXXXXXXXXXXXXXXXXXXXXXXXXXXXXXXXXXXXXXXXXXXXXXXXXXXXXXXXXXXXXXXXXXXXXXXXXXXXXXXXXXXXXXXXXXXXXXXXXXXXXXXXXXXXXXXXXXXXXXXXXXXXXXXXXXXXXXXXXXXXXXXXXXXXXXXXXXXXXXXXXXXXXXXXXXXXXXXXXXXXXXXXXXXXXXXXX
