---X--X-X?----oE-oM-EX--o-MMo-E--oB-?-E--E-BBXM??--MX---B--E--oM?X--EM-?---E---E-M--?oB----?o?--E---XXB?-B----?-BX--M---XB-----o-oXM-EB-MEB--MME-o------MB-EB-o-Xo?X?E-MMM-B--MX?MB---BBoE?X--?M?E--MoM-
-----E--XMB---?--ooo--BT-MX-EM--E?BBo---oBX------oE---B-oE--M--MoB--o---oE-BX---Eo--E-?E---B-o-oB---o-?X?-o-o-oXB-E-B-B?BB?--?X-oXo-XE--X-?----E---M-E-oo-BEM?E--EBB----------?----X----?-MX?EE-M-oE?---
--B-XE-o---X---------?M|---M-E-X-?MMo---XX-MB-oMo--M-XX-E-o-----B-?BEBM?E-?--?--o-B-Mo--B?--ooX-MBM--ME-X--X--M---To--M-M?o---E---o--o---oE---XE-?E-M--M--oM--X-o-M-M-MB-?o--X----BMBBB--?B-?-M---o--o--
-----?-E----------T?-ME|----?-E-?Eo-----E--MB--X-M----X-----X-o-EX---B?----E---M---oME-oo-B---?-X-T-?-----B----ME-|-o---E-----XB??------E-----?--E----Bo--M---T-M------?------?E---oE--X-o---------EBX--
-E-------B--EXX---|BB--X-Xo-B--o-BM------E-B----M---X----EoE---X-M-E-ME-B-E------M--M-E-M-----o--MX--MBo-o--E?o-B-X-E--MB----X------XE-M---M--o-XE----??-B-XE-|------X---o-X--E---?--?E----X--M-E-oMM---
--o--o-----o----X-|BB-EMo------M-o--TX-B----X--------oB----Bo----E-------E--------X-----EMoE-X---E-M---?--?BE--o-E--o-X--X-?XM----X---o--?-------B-------E---M|?X--BXo-Mo--?E-?----B-------B-----o---X--
-X--------EB--?-ME|-E-E----?----T---|--o---E-------------X--?X----o-?----?--?--M------E-M?M--------E---EM--M----BoE-?B-BX--?---?-----E-E-T-M----------o-------|-M-BB-----X------EX-----------E-XX----B--
-Mo----X-----Bo---X-----EX---XB-X--E|-----o-E-X---?---------Mo-----E-----?BM----T-----M----E--MM--B?X-o---EE---X-E-----BM---M-B-------E--|E--E-?-o--?--M------X-------M--o-?EB---EoB----M---XM--EMX---Xv
------------o-----M--B--B----E---M--Xo--M---T--ET-o--------??--?---E--B---E-M---|-----?--TT--?-?X-o?--?-TE-o---o---T----MT--?---M--o-TB-B|---T----oB--M--o--B-B--T--M---MEoB-M-------E--ooXB-M-?B-EXMEMf
--o--T-M------o-----------o--Eo----oE?B--o--|-EB|XB-------EB--X?B--BX?T-M-------XoM--X?--|XBX?-o-----E?-X-----M---o|--Xo?|---EM-----?|o--X---X--X--M-----------?-X----?---------X---EEoE--EX-M--M-M?---f
-M---X--M-M-MM------E-M?T-BTM-??oE-oB----B--X-o-|-E-oB--o-ME-?---E----X--?----M-------Eo-XE----?XBB------B----B--B-|-?--M|---ooB--B--X-------M-?-X--o---M--X-----oo---?-o??E-?TM--?---X-?--oM-----B---Bf
----o--T-----B------Mo--|TT|--E-T?Xo----------?-X?MX--M----To----B--X--TBM-o---M-M---M---EE?---MB----B-XT----E-X--BX--X--|---o---------M--X-Eo-B---EEMT---B-T-------M----E--?-X-B--M--MX---E-----ToX--Bf
--X--T-|-------------T--X||X----|----------------ET--------|B-------M--|-----X?------EoEo--?-----X------X-?-o---T-------XX-M------MX---o-----?---Xo---|T--B-|----o------TT?--X-------o---B------T|--o--f
-----|-|--------TTT-T|---||T----|-----------T--o--|-oM-----|-----T--T--|-T--?---------o-----------TT---T--------|-TE---E-T------------------------T--T||-E--|--------T--||M---------------------||--MX-f
m--T-|-|-T------|||T||---|||----|-T----T-T--|---T-|----T---|---TT|--|--|T|-----T---------------T--||---|--------|-|------|---T-----T------T-T-----|--|||T---|-------T|--||T-------T-------------||T----X
XXXXXXXXXXXXXXXXXXXXXXXXXXXXXXXXXXXXXXXXXXXXXXXXXXXXXXXXXXXXXXXXXXXXXXXXXXXXXXXXXXXXXXXXXXXXXXXXXXXXXXXXXXXXXXXXXXXXXXXXXXXXXXXXXXXXXXXXXXXXXXXXXXXXXXXXXXXXXXXXXXXXXXXXXXXXXXXXXXXXXXXXXXXXXXXXXXXXXXXX
