BBM?EXoo-o-X-oXE--o-oEB-o--MB--BX-Eo-XXXB-oE-o-B-EM-E-E?BEEM---BBEM--E-B-MMo-oB--o---B-X-B--?BXoM-M--oo?-?B-X-XX-B?M?-EEXX---BX--??---EMMMXo?BM-EXXX?BEE-X-MoB--EBXE-ooXE?-X---?EoXo-E?-B-----?--M-E-XX?
|-?--EX----E-B-Boo-oo----E-MXME--E-o-o?B------MEBEXBEo--oE-M-XM--XEEE--BBBX??oXM--Xo-----?oXo-??X--BoE-MXM-----BEM-E----Mo?--o-EB--X-M--BX--B-?--Xo-MBoo-ooMM--Bo--?-E?E?oEE-oBE?M-MM---o---B-o-?EXEM-oX
MX-E-M-?--E-T-?--E?--Mo-XB-EE------E---Xo----X-ME-MEBX--EX?X-E-BE?MM-oBBBE-??-?XMooo-o--M?XM---M-EEMXB-E--EB-XoBXM-?XEBM-oEo-X---oM-MB-o-B---B-MoXX---o----?-o-XXEXE-M--B--oM--B---?ME-?-oMB-?X-MXM?--BE
M----T---B--|-?--B-M-------B---------M--E--?--o-B?E-X-B-E-M-o-------oE----M-----X--M-M--o---?----B----E-M-M?--X--E----o---E?B-?--o-------?-XM---M?--M---EM--M?-E---M-X?----?---M--M---E--X---B-o-EB--M-B
B---?|?E?EX-|o?--E--o-Xo-?M-------XM----?XoM----o---?-M--------E?TX-?T-o-X--M--E--X-o?-E---M----B-M??o---T-o---B------E---M--M-X?E--XB--B-----B?-T--?-X-M--E---o-E--X-M---Eo-o-BM---XE--o-E?--T--B-BB--E
M-E--XM?----X-?X---o-----M--M-?----B-----B-M----B---M-----------B|-?-XX---X?B--MX------B--Xo----B---BM?-oX-Mo-E-M-?-BBMB-X-?-MoBM-o-o--X-XE-----o|--?-?M?-EM----?oB--BB--X----M-?Eo-EBM--E---XX---M-E?-M
T---B-BEM-EX-o---X----?----o---X--M--M?--o-B--EBB---?-XM-o--M--B-X----Bo---o-------BB--M----E-XB-X?---M--------?-X---?-oo-Xo-------o-E-------Xo--|------B------M-B-E---EB--M-E-B--M------------X-?o-M--?
M--?-----X--?B-oM-X--M--M-------X-----------M?---XB-----?o--o----E--------M----M--EM?-Bo-----------X----M---M---X--M--X--?o-E?M?-----B?-X---oBM--|-------B-E-E-B-------oE-B-------o-----M---E-?MX------v
EB--B?---------E-M-?----B-BM?----?--X--X--ME------BX-X----?M------XE-E---E----M-M---Bo---o?---M--X--EoBX--X-M-----XM---XB-------X--EE----XX--B---XE---B-----X--B---M--B-E-EMXo--Eo--X--M--------B-----XM
o??-B--E-------BB-M--oo-M--E-XEB?--------?---?M--B--X-E-oB------X--B-------?----EM---E---o-o-EBM?oE-----EM-?-MBXMX--------BEE--M--M-?o---M-E-?---E--?Mo-----M---Bo-BXBE----E-B-o-o----MM--M-X---?o--E-Eo
BE--B----MBX--?-M----o?E--X---------EXM---X-?M---B-EBXEo---EXE---E---------oX-M--MMX-----oBB---M-M---B---BE--M---oX---E----?o-----BEEBo-?E-EoBo----M----X----??M-M----?o-E--oB-B--------B-------M?---?M?
T----o---B---B--E--XM---XoEEBXT------------M--M-E--M----EEX----?----X-----XM-o------o-----------XoEB-----ETM-?------B--Xo-----M?--M-T------?o---B--TM-?--------B---M-oB-o--E---o--M-?--o-MT--o-B?B-oX--B
?---o----MX----X-E------------|------T------EoB---B---M----B------B-M---E--B--E-----M---BM------M-?M------|o---X------o-----E-T-X--o|--E-----oT----|?-------T-----E?BTo---B---E--X-E---T-o|------o--M-BM
M----o-E-BMBX--B--EB-----?BBM-|X-----|M?B----------o?ET--MX----------------BB--BM----------X-X-M-T---T?---|EE?--?---X-M--BBX--|-----|-MM-TXo--|X--?|--o-----|EBE---B-X---X-M?B-------M-|-o|-----?----XoM
m-T---------------------------|------|-----T-T--------|-----------T-T------------TT-T--------T---|---|----|--T-----T-----T----|-----|----|-T--|----|---T----|-----T----------------T---|--|T-----------?
XXXXXXXXXXXXXXXXXXXXXXXXXXXXXXXXXXXXXXXXXXXXXXXXXXXXXXXXXXXXXXXXXXXXXXXXXXXXXXXXXXXXXXXXXXXXXXXXXXXXXXXXXXXXXXXXXXXXXXXXXXXXXXXXXXXXXXXXXXXXXXXXXXXXXXXXXXXXXXXXXXXXXXXXXXXXXXXXXXXXXXXXXXXXXXXXXXXXXXXX
