??-----B-XoE-BMB?Bo--o-E-X-BE??B-Eo-M---o-E---MXME?o-X?-BB-E--B?o--oMoB-ME--X?-o?-BMo-BBB--E-EXXMXMooXX-?-EXX----o-Bo-E---B---B--XXMX-E--E--E-M??B-MB--X-?M-EoXoM-oB-X-oo---MMB-?o--o--ME?MXBX---B?-Bo--
|--EB----EBoTE-MMBoEo-?oo-X--MX--o?M--B-B--?E--B-X---?---X--EM?----MM---XE?M---???oXE-oX--MB--X--B-M----E-EE?EE?BX-B----ME-oEM--XXoB-?-M---XMXBXEoE?Eo?--E-E-?oMBoo--?--?-BBEMB--?-?---EXBXoM--?-X---X-|
X-?-EBM-oX?-|B-M-EEo--?-MBE?MX-EEX?X-XMToMEoE?oE--B?MEo-B-?--E-----MoMBBBXBXBXB?-E-----?BB-MX-B-??ME-X?X---B-EoXBoME?-XBXX---?E--X--?MEEMoB--M-Eo?----o--Eo--X--EoE?X--MEEEE-oM?M-X-M?-E-o-E------MM-BMB
B--------E-M|-M--o---XM-M-------B-E?--o|-E---o------EM----?XX---o-oB-------o-E--XMo---M---------M--X----M----B-MB------o---E-M--E-??B--o----ooM-EM-XBB?-B?X?M-------E-----T?--X--M-?-M-o--M--------B---|
------------X-------B-----BM----B--?---XMoM---E-?T----XBo?---E?--??-X-----BBo----M--BX-----X---o--Mo--B-B-EX--X--XX------X--E?-M--------B?---o---B--?----M?B-B---XMX-X----X-XX-M-M----MBE---ooM--o-----?
X---M--EBBB--M-----M----X-EB-oM-?------o---M-MBX-|B-------?oM-------M-----?-o--?Xo--E----Eo---X------------E--o-M-?----M-o-----EM--X-------X-------E------o--B-E-o-MB--oMM--o-E---X-----o--?Eo-------X-o
MBXoE-BE----B---B--?-B-X-BME-B-?-BXMX-?o-X-o-M-BB|-BMM----?--B----BXEE?o-o-X---M-o---M----B--M---o-B---?--------MX---Xo--?B-XXE-M-M--o---E-?-?---o-----?o--Bo-E---?-----?---Mo---?--X-----M--oM--B---B-T
--ME--?-----o--------M-oB--M--X-X-Bo--?---o---o--X-?-E--XEBB-M---M-oBEo-EB-oX?E--MX-B-?----o---E-oB---B-o--?-BE-M---XB------?------o---?--B?M?-B-oE----------------X-oo-EM----o-E-MXM---M-??--E?-MM-X--v
?X--o--B----MXEX-M---o-B---E-----XB-X---Eo-X-?--EB-------B---o-?-o-M-?B----??-BoX-?-?B---M---E-o---o-X-o--M----o---EBE---?---X------MXo?------Xo-E------o----B----X?--Eo-M-X-----MM----?-----M----oXM?-|
E------o--------------?---------?-MM?X---E---E--B--o---o------M-B---E--X?B--?--E---X-?-?-o--B--oX--EM-M--oE-------MB-M-X----B-------B-----X?EE--M?X--?B--EB-ME---?--?EE---E-----------o-MBE---B---?-E-MM
-------------MoM--M----XB-E-MBB-o---M-?Xo----o---Bo--?EM---E--E---?--o-M--B---?--?E-Mo-E----E--------oB-B---XM-?BBEM-?E---------oM----B-E?----o---MT-------??-X---oB-----B-B---?-?B---B?-------B-E-E---|
---B----EM?-BB--M--------M--M----o--?EEo-?---E--X?--M--oM--oBM-X-oETB-----o-----?-M--E---B-M-------BM-M---MM?------oXM---X-E--X---XM---------------|M-o--E?BM--EoM----M--------B-?--B------B--?--o--B-oX
ME----o-B---M-?-o--?-----B?----ME--E?-----o-B--------?-E-MB---X??-?|--o-XE--?--E----X--o-B----E-?E--?--?M---E--o-B-?M?-oo-M----?EBE-----X--?M----E-|-B--M--oo-?--BE--o--X-X--T-E--EM?--XEBo------------T
X--BoXE---?----EEX------?----MME?--E---o-------M???o----ME-?o------|---o------o--EE---X--M--?E-----XE-E?o-?B-----Mo-----B-E--XX-?B-------X--MT-----|-?----------B---o?-X?-oM?|-----B---------M-XE-M-----
mo-B-MMoM?-BX-BE-EX-X--X-M-B---E?M?o--B-M?EE----E-Eo-o--BEoo--oo-B-XoB-BMXBXE-E??Mo--o-oMoXoME-M---oo---E-?-M-E--?Bo--o-EE-o---BMoooE?MBX----X----XXM?EBo??-oXX----EEMX-?oMo-XBBMB-EoB-o-M-?o-o--?--MB-o
XXXXXXXXXXXXXXXXXXXXXXXXXXXXXXXXXXXXXXXXXXXXXXXXXXXXXXXXXXXXXXXXXXXXXXXXXXXXXXXXXXXXXXXXXXXXXXXXXXXXXXXXXXXXXXXXXXXXXXXXXXXXXXXXXXXXXXXXXXXXXXXXXXXXXXXXXXXXXXXXXXXXXXXXXXXXXXXXXXXXXXXXXXXXXXXXXXXXXXXX
