----M-E---------------------------------M---------------X-------------------------B---------------------------B----------B-------------E-----------------------------E--------------------o-XM----------
------------X----------o----------------o--------------------------------------------------------M----------B--------------------------------M-----------------------------------------------E-------M--
--------------X-----o----------------X------------------------------------M----------------------?X------------------------------------------------------?----X--------------B-------X-------------XX---
----E------o--------M-----------------E-----------------------------------------X-------------------E---------------------------------------------------------------------------------------------------
-----------------------------------------------------------------------------------E------------------------------M-----------------o----------------------------X--------------------------------------
----------------------------?-------------------------------------------------------------------B---M---?-------------------------------?---------------------------------------E-----------------------
--------------------------------------------------------------E-----------?-----------------------------------------------------?----------------------M------------------------------------------------
----------B------------------B---------o-----------------oE-------------------M------------------------------?--------------------------------------------M--------B----------------oX-----------------v
--X------------------------------------------------------------------------------------------------------------------------?---------------------------------------------------------------------------f
-M----------------------------------o-----------------------------------------------------------E-------------M----------------------------------------------------------------------------------------f
----------------------------------------------------------------------------??----------------------------M--E--------B---------------------------------BX--------?------------------------------------f
--------------X-XT----M---o--------------------------------------------------------------------------------------?-------------------------------------------------------------------------------------f
---------------M-|---X---?---------------------------------------------E---------------------------------------?---------------E---------------------------------------------------------------B-------f
----------------TX--XMT--------------------------------------------?-------T---------------------X--E---o--------------M-------------------------------------------------------------------------------f
m---------X-----X---?-X---o----X----------X-XX----------------X------------X-------?------XX--------------X-------X-----M---X---X---------------XX----X------------?------X-----E--------------X-----X-f
XXXXXXXXXXXXXXXXXXXXXXXXXXXXXXXXXXXXXXXXXXXXXXXXXXXXXXXXXXXXXXXXXXXXXXXXXXXXXXXXXXXXXXXXXXXXXXXXXXXXXXXXXXXXXXXXXXXXXXXXXXXXXXXXXXXXXXXXXXXXXXXXXXXXXXXXXXXXXXXXXXXXXXXXXXXXXXXXXXXXXXXXXXXXXXXXXXXXXXXX
