-?XB--X--M-oE--X-BM-B----BXMEXEBo-X?--?MEM----E-?M--B--M-M-X-EBo-?-o?-X-o--MoBBB-BooBX---B--E-?EM??-oXXoBoE---XE-BB--BBX--M--E--o-B--?MoM--o?E-----EXEoBo???M--?X-?-MEB---M-oE--?oB??oB???---XBX---E-oM-
--BX-EEMM-?BE--EBo?--Eo-oB---BE-XooXEooB-BB-M??-BB-o-MM?BEEoE---BX-XoMBMME-?-Xo-?-?EM--?EE--M----Xo?-BE-Xo-MooXoEoB----MM-EoEEM-oM-E-----M---E--?--B-oMBB--B-X?B--oBB--MM-M--M-EBoM-?o-EME?oB-----B--?o-
---?M?-EEBM?Eo-----?EB-?---BEX-MM-?--M-Boo---E?BB-EBoXM-Eo---------B-o-?Mo-EEo-----X--X?-XE-XBBB?M-o---X--?oB-EE-MBB-X--E---BE-MB---?-EB?--Eo?-oEBBo-XEB--M--M-EM--E--XE-E-??X-B-E-E-o-BXMo---B-XM--?o--
-X-EM?--ME-T---XB?-ME----X--?--o-E------E--E--------o-MX?----X--X-?BE--M-B-?X--X?-M--MBB---E---EB?--BE-??--E--X-------?X---M-----o----?----XE-----BE-B------oM-XT-----?-B-oEoXM---M--XM--B?--E-B-E---E--
-----?XX-B-X-M-----?M?-M--EB------X---BXB?X-EM-BE-----o?MX----?------BB--E--Bo-BB--oT-------XE--?--X-----XE------B------M----M-M-----E--X--E----X-----?--Bo-ME--|?-E-E-M----?ME----o-M-M--B-EBM-E-oM-o--
--?-BM-M--M--B---o-o-MT--?o-o------Mo-o--B---?--?-XX-M--ooM----Mo----------X-------EX--?oo-X-----M-----?---MX-oX--?-o?-?--MEM----?--XB--M--MM-EB-EEo?o-EM--E--BoX----B------o-M--?X-?XX----X-?BB----M-M-
---E--Xo-X--M----B----X---?X-E-EM------MM-o--?--------M---------EM-?--B-X------o---?-To-------B-----------B---MoEX---oMBo---o--?--M-M-BE-?--E-M-B---?-?-EXB-----EoE-E?---E--?o-?-----oo-E-M----o-----oM-
-X?E--?-XoE-------?T-B--MM-M--B---EM----B-ME-?-----Eo--?-B-X-M--------MX-BM--B?BXM---|MB----EM?ET-EB--EM---MX--------?--o--B--B--?-----o-MXM-EE?-MB?--oM?-M-XM---B------X-E---M-?B-o-B-----E-----?B-?--v
---BoX--EE-o-E---o-XEB-o?----??-------Eo---------?---o?-E---?------M-o--------oo----EXM--o--M---|---E-------M-EX----X---MT--E-E----------B--M--oM----o-o-o---E-??-XM---o----E-ooB-----B--?----B--M-X-o?f
-----?oBE?BXX----E--?--o-M----MB------oMBM--------E----B?Eo-MBM------Mo-M-----B----o-?--o---B---XBE-E-oo--XM?-----B-o----|oX---E?----??-XoXM?o??-B---E-o--XTo------ooEo?---E-----XB----X?--?-EM-X--M---f
-------BM-o----XEo---M?----?-E--------B-------------------?M---BX--o-??B----E?----o------?--M------XE-M-X----?-M--o-o----|MEE-----oM--E--M-------o------M-E|M-MX---E---E-EX----oEBM-E?X-o---?----BX---Ef
-M-E---------EM?-?X?---?-M?-XB?-o--o---o----?EXoo------B-E--o-------o------E-Eo--BE-----Eo---XTX----o----MM?-B?E--E-E-?-oXEoE---B---EB------X-B--oX--?o--X-X-BM---Xo?---BEo--oX-?-?-?--E-X----o-Eo?EE--f
--B-?--EB-B---o-?--B-E?--M-BB--o------E----M-?----E------E--oo-E-EE--M---?--B---o------o---B--X?E?B--EX?E?--XBo----------o------EEXB---?-----?-M-----E-M-M----?B--o-oMMM-BB-M-?-B-T---?M?M---M--Bo--M-Ef
--?o-?E-o---?E?-M-X?--E--o-M--M-------E-X-E----?oBB--M-oo--B-BXo--B---o?-?----?--oo-o----B---M--E-----M--o-B-o?--o-E----o-T--?X--MM-BXM-o-o--?X----EX-M-----?--B-X---------M--MM-E|EX-TM-----------o--Bf
mX?oo-EBB--M---XBBo?M-E--E-EX--E--?BM-o-E?--XBoo?-o--MM--?o?o-o-BE-XX-MMXoE--?--B--?MBE?XE?-?EBE---MMMM-XB-MXoM--E--B?Mo-BX?oEEXM-?XE-BEoo-oB-E-EX-ooEE-BEEM-?B-o?-oo?o?XMM-o-M-E-XEBXX--B-??B?E-Bo-B-MX
XXXXXXXXXXXXXXXXXXXXXXXXXXXXXXXXXXXXXXXXXXXXXXXXXXXXXXXXXXXXXXXXXXXXXXXXXXXXXXXXXXXXXXXXXXXXXXXXXXXXXXXXXXXXXXXXXXXXXXXXXXXXXXXXXXXXXXXXXXXXXXXXXXXXXXXXXXXXXXXXXXXXXXXXXXXXXXXXXXXXXXXXXXXXXXXXXXXXXXXX
