o-?M-B--E---B?EoMoXB-M-M-M-o?M-?-oXE??EBXE-XX???X-MEoE-B-Eo-M-o--EBE-?MBBMXBEMB-ooB??MBE-?o---BM---??E-M--X?--o-E-Bo?X?--E--EMBEX-TEE-o?-?E-EXXB--M----o-B--X---XXX-o--XoBXMM-?-o?BBoX--B--?--Mo??--XE-|
--M?XX---XMEXB-B-X-Bo----?-?--oXX--TE---o-X-ME--oEM------o---M----?-E--M--MBXB---B-?--o?--o-M--XM-E-oEMBME-XB?B-oM?EX-B-X--MX-M-oE|-Bo-----o?---?M-B-?--BX-?M--EX------o-E--oM-BoEE---o---o-?X-XEE?Xo?-M
X--M-?X--B--X?--X?--o-M?---MBoMBXMo|M--o---EM-EX?--o?E-M---E?BoEEo??-B----?--BoME?-BBoM--M---o-----EB--BE---BB--?M-BB-----E-MT-E-M|o--MB?-EEo-?M?o-M---M-XM??----M-E-o--?M?--B-Mo-MB---M---?----E--B?-oE
B?-------?---o?--o--T--E-----X-?BBE|---oBX----E---?-Eo-Xo----EX-oBME---E----?----o--M-o-----------------E---??----XE----XM--T|E--M|--M----E------M--o-----M-o?-----E----M--X---XXo-------ME-E-M---X--E-|
E-M-X---?--X--E-oMB-|?--X-?EB?E---oX--TBEo-?-B-o------------o---?o---?M----T--B-ETX-----?-X--------EX--X----?----?----?---o?X|----X------EM-B-o?--?----B-?-X---o-E-?--E----------B---M-o?-E-Mo-E-BME-B-T
M--------X-Mo--BBB--|--B------o---oE--XoT------o-?---EM?---oT----Mo---BX--oX-o---X---MMX?-EXE----?---M--Bo-XoM?---E----o---E-Xoo-o------X-M-----M-----TE-M---B--oo-?--B--o-M--EX--X-o-T--------E-o-Bo--M
X--B---X-o------M--E|--o--?-------?-M---|-EBMB-M---------BT-X-------???----?-?-----BX-?o---B------BoT----B-o--?E?--M--X--E--?--?----X?-T-E-?-o-BB----X|-----E-------E--X------B---B-E-|-M?-X-o------E--X
o-Xoo--B--E-M--o-EM-TX---M---------?----|-??--------E?o---|-ooE-----o?B--MEB-M--------M?-EEo-MM--Bo-X-BM----ooo----oMBo?----?-?----X---X-------B---o?M|-----E--B----M-o------M-BB-----|M--oB-BBE?-o----v
M-o-o---X-E-M----B--|EE--M--E--?-ooM--B-XB-------XE---EX-BX------Eo-------------M?TXo----o--M----?MTo-M--?------X--?----X-?-----X------B----oo--------X-B-XX------EX-E--M-M--?X-------X-----ME----?----B
---E----Bo---B--MMB-|-----E--M----E---------E---X?------o--------?--E--T-o---M-o--X-----M----M?-M--X?T---E----?-E??o-o-------?-------M-??M?-----BB-?-oB-M-?-E--oX?-?-----------?----M--M-X-MM--MX-Bo--EX
?------E--?E------E-X---EXM--M---------X--o--T-E---?BEo--E-ETTX--M-----X-----o-?X-MBB-------M-M--B?B-XE---B--------------B--E---E------o--o--EBB----T-?-o------E---M---?------E-?-XM-o-E-M------M?-----o
o---X-E--X--M--------------o--X---------TM---|---M---E-Bo-X?-X----MMT-TBM--T-B---B--T-E------X---T------------X-B-B------M--MB-----XE----T--X-----E-Xo-----------BM-X-X----Bo-o--T--------MX-------oTo?T
X-B--oE-B--------------------?B---------|?TMXX--------------XB------|-|--Xo|-----M-X|----E--X--T-|-X------------oBBoT---E----?B------?---|-------oo---M-----M--M----E--B-X-o?----|TX-?------BT-----B|-?M
?-TT----T----T----?----T--T---E--------X|-|E------------T----EM--T--|-|--T-|-------T|--T--T----|-|--------------TM--|---B----o------o----|--B--T------?-----------X-?----------M-||-B-------T|--T---|X-M
m-||-T--|----|--------T|--|-----------T-|T|-------------|-----T--|--|T|-T|-|--TT---||-T|--|----|-|--------T-----|---|----T-----T---------|---T-|-T--------T----T-T-----------T---||---T-T---||--|---|--?
XXXXXXXXXXXXXXXXXXXXXXXXXXXXXXXXXXXXXXXXXXXXXXXXXXXXXXXXXXXXXXXXXXXXXXXXXXXXXXXXXXXXXXXXXXXXXXXXXXXXXXXXXXXXXXXXXXXXXXXXXXXXXXXXXXXXXXXXXXXXXXXXXXXXXXXXXXXXXXXXXXXXXXXXXXXXXXXXXXXXXXXXXXXXXXXXXXXXXXXX
