-E-MEo--oBE-Bo?oMM-??X-oXB--?XEoE-oB-?-BMEM--o-E----M-EB-E-MB--E-?-B--E----?-?----?M---M-----EEBooM-M?MM-XEEoB-?-?M-B?--Xo?MB?Bo-X-X?M??EBB-B-?MBo--M-E---X-M---B--B-oXM-o--XM-??------BX--oE---X-M?X---
--B-X-o-o--?XBoE?EoM?oo-o?E-MM----BoE-B-E---XBX-XEEo-B--B-E--BXBM--X--MX-BoX-B--X--?E?B-EBXX---ME--MM---o---o---XX?--E---?---X-MXB--o-?--EE-TX-E--o-?-B--B--M---?-BEXoo-E-M?-X-oXM-?o-o??-oo-M?E?-BoXo--
--oBM-XB?B-MB-?ME-------XXoME--B------?---?-?EX---XE-B--MBM-----M?M--?---E-M-X--?--M-o-BXEoo--???M-MM-M--o---ooX-o-oMMX?--?E-?--------oX-oM-|-?-o--BEoo?-?-----XE-o-M--EE---M----o-EB-M--BX---MoEB---X--
---MX-?------M--M--MB?---oo-MXB--o-----E--MM----oo----E-?-------oE-o--XM-------X-B--o--------M-EMX-o---E--X?X?BE-o---M--BM?-E--o----?-----o-|---M----EooEB-----o-o?---Xo-MB-oMX-E----E--------B--X--o?--
-BB-B-----EXX--B?------X---X-----MM?o-------?--B-----E-----oB----?---?---o---XE-Xo-B??M---BM--X--E---E------oB-B-----o?---------o-M----oEBo-X-Xo-XM-o-?--M--E---M------------B-M-ooB-M---------BXo------
-B-BE------T--?---o---EB---E-------M---o-M--?------M--E--B----Xo----E-o-XoB----B-M----M-M---?-E-o--M-E--EB--B-?--B---E--------BXB-o---E--?M----E-BE?-o--B--?---M-M-------B---EX--B-B---------X--?-XE-o--
----B------XM----o-?X-B---M--o------?o--M-M---B---M-B-?-o--o-----E--EXMT--o--M-M-B----?----X-o-M--T--M-M-------o--?----BM-----M----?-----BE--B-MXoMMBE------??-------o--XE-B?-------Eo----o---M---?-----
-B-X-M---BX---M--o-E-----M---E--BE------?-------E-o-BoEM--------B--?--BX?--o-----M----?---B-M-----|o---B-------o-M?M-?X-M-X---M?-----?o-B-?----?----------------?oBMM---B--E?-?X-Xo--M--o---TX--B-E--o-v
-T--?B-oo-M--X---B--?---X---XE?-----oo---MT-X-BB-o--M--EoBB--oE--T----B--B--X-?-E?M-?---?---E--B--|------X?---X?------oEo-?M--?-X-M---M--M-o---E?B---E-?XE?---B--o-o-B---E--?-M-B---M-----M-|E??-------f
-|-o----E---o---?M--?-X-B?----M------?--X-|BMo-MME-?--------XM-M-|-M-X---o-B--------?--?-------o-XX-o--o---E-?--M-EB-----B-MoM-E--M-X-------BX-E---?-o-?-Mo--B?X-?----B??---?--?-E--E-BE-E--|o-----XBX-f
-X-T?-X-E---M--o--M?-XBoE-----M--E--?-?--B|B--XB---B-----M-----oo|-E--B----MXM-----?---MXEMM--XoXE----M--E-----oBo-------EEo-o?--M-------?EoBB-B-----o?EE-Mo-MM---X-M-o?---?------?---B---E-|-----?----f
--EXB-ME---BB?----------Bo--X--E----E-E-M-|M---o-Xo--XBB--X--EEBoX-----?oMoB--T--X-?-XB-E-B-EBo-B-?-B--oX------Bo-X--EM-E-M-----XB-M-M----o-E-oE-M------o---X---Eo------XM-Eo-M-------M-o-oMX-----EB---f
-?o-B--BE------?---------o-E?E----E-BX----X?MM?----M--o-M-MX--B-Eo-o-oM-----M-|?-----M-X-ME-?---M-M-?-B-o----M?MMo-M?------?o--E-?-----?E-----?M-?oo----MT--?-???-o-M?----M-o--E-?-M--o-----??oo-------f
--?-----E-?-E-MM-X?----EE--M--Xo--M---B---------E----EMM?--?--o-?T-??o---ME---|--?EB--M-B--X---X--T---------BB--E-E--X----M------o--XM-ooB--oXo---?-B----X----M----BEM-B-o----M?--M?BoM---B--T---------f
mXBE-o--o-B??B-oo-BXX--MBBE---BE-Bo-B----oM---o---BMo?-----B--BXXXBBEEX-X--EXoX-E?--MBBE-X-BXMX---XB-BBBo-XBMEMBBB-EMoXXX?---M-oB-M-B--EM-BMEBM----M-----?-B-X-o-?BMoBM-o--XB??-EXoo-EM---?-?XEXEM-EBM-f
XXXXXXXXXXXXXXXXXXXXXXXXXXXXXXXXXXXXXXXXXXXXXXXXXXXXXXXXXXXXXXXXXXXXXXXXXXXXXXXXXXXXXXXXXXXXXXXXXXXXXXXXXXXXXXXXXXXXXXXXXXXXXXXXXXXXXXXXXXXXXXXXXXXXXXXXXXXXXXXXXXXXXXXXXXXXXXXXXXXXXXXXXXXXXXXXXXXXXXXX
