o--?-X--Eo-MX-X-XoE-ooMoE---ME?MM?--oBB-BTX-M-M-?-MoBB--MBB--o??-XXMB?M--M-XoXoo--M-?X-o-?-EEEM--ME-BXM-?M?EEo--EXXoEM----M?M---?B-XMoE--E?--BXEXM---oo?XXM---XEEXX-EEBX?oMEoo?-E---B---?-XE?-B?--XE?--T
oX-?E-M-o-ME-Mo-oX-?X--BXoMXM----B---EBo-|?---BBB-X?MEM---EX-XXB-Mo-?B-M-XXo-oB-X--oo??--X--?-M-?Mo?-oXT--EE-BM--M?-?-XE-MX?MM-oXE-XE--BMBX---o?Eo-M?EM-B--B-MBM-?M-XBB--Mo----Bo-B-EXX-?--BX?-X-----XX?
E-M--XE--Xo-E-?-BToXT-XX-XoXXoBo?-?-oT-o?|E---B----???o-To---Xo-M?X-B-EEX--B-----X?-X------?-oBB-BTBM-o|EX--X--X--o----B--EB-X-E?-M-MX?--EoB--ME---XMM-M-o-EXo??-------BBoooE--MM-o--o--M-EME---o---BEB?
o-----?-oE--XX-MB|--|--?----E-?-----M|---|-o-------M-MX-|--------------BB----X--X-B-o----o-B-B----|----|B?-B-E-Eo?-BM-M---B-X---XoBEB---BX------o------?-------B-?--BBo?-------o-M-X----M--?X--T?---?-oo
T---M-MBM-------MX--|---?--T--BE----B|--XX-----?--B--?--|-----M-M-?-o-E-BEo-B-M-To-----------E--?-X----|---------EM--------E-X----?E-----MM----EE----EEEM----?--Boo-T-B-?-M-------?--E?---T--BoX-X---E-M
B--?--M-B----?X---EoXME-o?-|--E-B----|-T-o---EM-XE-BT---|-oB----?-MEB-?--E?o--M-|------o-M?----?B----XTX?M?M---?M---------BM------T-B?o-----?B---B--oB-?B-XX?---M-oB|-E----?M--o-E-E-E-B--|----------E-E
oM------T---?-E-------?M--?|-E-------X-X?Eoo?----T-o|---X-----E-----------Eo-B-?X--o-oo------?--T-M---X----?oo---BXB---E----X-M--BXM-----M----B--?--?-----BM------E-|-B----B-B----??-ME---XoBo----X-BB-M
?-------|E------EE-?--M-?--X--M-XE-MX-oMM----?---|--X-E---X?----?--oMXE-ME-M--------X-----?E-M-M|-M-----BX-B------B??--?-M-oMM--?---B---M--X--T-B?--E-o--B---M-E-o--|--XB--B---B-M-E---------E-----ME--v
M-E----XX----EE--------Bo-??-------B----------B--X-B?M------o--M---BE--?---E?-----?---X--X--Mo-o|-?--BoE-----E--X---Eo--T?-To?X-----MM-o-Bo--XX--o--E-M----?----X-B-X--M-M------?-?---B-X-?---MMX----BBT
X---E-----BX------M--M-MT-?---------M----M-M-------B--?---E--o--M--?-------?M--------X--?MM-----XB---E------?B-B-o-Eo?oM|-M|-T-EE-X----?--oX----o?-T-X---E-------?M-----X--B-------M-o--M----o-----?M-Eo
T-o----E-EE--B-Xo-----M-X--o--?------o---?Bo---XM----ME---?---?E?---oBo-?-X---E-----B--------E-B--M------o-o-B??-M---o-oXoEXBX--EB---B------?o-E-E-|---E?BM----XE--BBM---------?--BE-Eo-?B-------E?--?-?
B-----E--?-TX--B-ooTEE---B-o----?--?B-Xo--M--------o------M?-?-o----------E--------XT--X-M-----oB---M-E------T?o----o-oMB-------B----T-----E-------T-B---MTX----TT---o----------------T-T---?----------?
----o-M----|-------|-----o--X----o----T--------?--M----oE---------T------------o----|-----XT---T--?E-----B?--|-M---?--M----T--T-B----|----X------M-|---T--|-----||BBX------M-E---XT---|-|--M---M-------E
o----E----o|------T|ET-------------T--|-o---X-----B------T-M------|T-----M-----T--T-|--?---|-E-|--B--TT---E--|------M------|?-|---T--|----T------M-|---|--|oT---||?------B----T---|---|-|-M----TM----o-|
m-T--------|-----T||T|-------------|--|-T--------------T-|--------||-----TT----|--|-|------|---|-T-T-||------|-------T-----|--|---|--|----|------T-|---|--|-|---||-----T------|T--|---|-|------|-T-T---X
XXXXXXXXXXXXXXXXXXXXXXXXXXXXXXXXXXXXXXXXXXXXXXXXXXXXXXXXXXXXXXXXXXXXXXXXXXXXXXXXXXXXXXXXXXXXXXXXXXXXXXXXXXXXXXXXXXXXXXXXXXXXXXXXXXXXXXXXXXXXXXXXXXXXXXXXXXXXXXXXXXXXXXXXXXXXXXXXXXXXXXXXXXXXXXXXXXXXXXXX
