----BM--M-----X------?------------o---E--------------------M---------X-----------------------------------o------------------B------------B-----------------M------------M-----------------------E---X---
-----------------E------------X----------------------------E--------------XE-------------o------X------B-----o----------------------------------E----------------------------------------------------M--
-----------------------------------------------------------------------------------------------X----------------------------------------------------------------------------------?---------------------
------------------------------------------?o----------o----------------E-------XM----------------------------------------------------------E------------------------------------------------------------
---------------------------------------------oX-------------------------------------B----M-T---------------------B?--------------------------M----------?-----------X-----------------------------------
---------------------------------------------------------------?---------------------------|------------------o------------------------------------------------------------M----------------------------
--------------------------------------------------------------B----------------------------X-------------------------------------------------E----------------B-----------------------------B-----------
---------------------------E---------X----------------------------------------------------------------------------------------------------------------------------------------------------------M------v
--------------------------------------XT------------------o------------------------------------------B--?---------X--------------?---------------------------------------------------------------------f
-------------------------B-------------X--------------------B-----X-------------------------?---------X-----------?-E-----------------------------------------------------------E------B---------------f
--------------------o---------E--------------?-------------------------------------------------------------o-----------------------B----------------------------T--------oo----------------------------f
------------------------------B-----------------------------?----------------------------------X--------------------------------------------------------------?-|------o-----------?------o----------B-f
----X--------------o-------------------X---------------------------------------------------------B--------------------------------------------------------------|---------------M------------------X---f
------M?B-------------------o---------B--------------?------------------------------B------T-----T-----------------------------B----------T---------------------|--------------------------------------f
m----------------------------X----X-o-----M-o--------------X------X---------------?----X---X-----X----B-------------oX--------------------X--X---------------X--X-------X-----------XXX--------M-------f
XXXXXXXXXXXXXXXXXXXXXXXXXXXXXXXXXXXXXXXXXXXXXXXXXXXXXXXXXXXXXXXXXXXXXXXXXXXXXXXXXXXXXXXXXXXXXXXXXXXXXXXXXXXXXXXXXXXXXXXXXXXXXXXXXXXXXXXXXXXXXXXXXXXXXXXXXXXXXXXXXXXXXXXXXXXXXXXXXXXXXXXXXXXXXXXXXXXXXXXX
