MXEMEEBB-B--E?MoX-B---?oM--M------B-oBoE?EBX--BEX---?----o----MXE-X--?MBMMMBXX--??-EBE--?XXXX--o?-??oX-B----??oo--E-Boo?M--B--Eo-MM-MoXoX-o--o-BX?XX--X--E-o-----B-EXEEBoBX-XE?--B-B-MMoB-XM-MBEMB-E-MXX
EB-------?B--??MXXBoXE--E-oEB---MMMB-oBMoo-?XXX-?o-X--oEM-o-B-?-XMo-----X-MM-XoXM--E-E-E-EEB--BX-E--MXBXXoE?EM?MMMXo-?BEEMMBX--B-BXE??---XE--E-?oME-------?oB-X-oB-M--EXMo--oM-B--ooo--?-E---E-?o--EXM?|
T-B-E-XB-EBEM??-BMX--M-M?EBoXE-EM?--M----o-M-MX--Eo-?-?--oo--E-M------o-E--MEE-o-??oBoB-BoEBo-T?--o-----X?----EX-X---B-?X-MMX-EM?-MMB?EoX-XXM-o?--?B--BEE--oXBMo---M-M-M-??--E-B-E-oMX-----XE-o?----o-BE
X--MM----EMo----B---o---BBE?---o---------Mo----M------B?EX--X-M-------?---X-M-----Xo-X-------E|Xo----------E?--oX-oo--o---?---o--o-?--X----------oX-----B-T-X--?-MEB------?-?--B-oM--------o-M------M-?X
X--o?oo---Mo--E--XX-------?-B----o?---X---------?E----T--M-E-X--o-B-E------EEEE-o-M----M--B-MB|-BX-B-o?-o-X-B-------B--T-E-M?---?-B--B-------XMBTE??-oo--B|--EM-----------E-----M-T-----M-----ET-B---oBB
MB--EB-?B--M---??-o--M-EB-MB-T---E----o-X-X-o-----E---|M-----oE--B-?--E-E-M--?oEo---XX-----T--X----??--?---T--MX--?-E--|-------E-X---EBE--o----M|?EB-B----X-----E--XB-----o---o---|-----E----M-X--BX--B-
ME--M----Bo----T---X-E--o---EX--?-----M-o----o----B--XXT-EEo-E-T--X-BX?B---B----M---MMo--Mo|--?-MM---------|B-o------TE|-E---E--MM---------TB---|----E-X--?XEXM----------E--------|--E-XM-----------T-M-
M--E--B---ME--?X--X--?-------?o--Xo-B----M-E?o-----?---|E-o----|-?---o---E-o--------o?--?--|o?---MX--------|EM-oB----|-|M-B----B------B----|Mo-MX--E-?o-X-oM-------E-?X-E--X---T-EX-?-E-B-X----E--M-|--v
E--B--B-EM-----E---E---o-X-M?--TM-M-?-o-o--oT----?-M-E-|----M--|E-E----B-------X?-?-----?T-|-E----------o-MX--X-o----X-X-E------X----M----E|-EX----M-oBM--o----B--M----?M?---M-|----B----?M------E--XB-T
|-X?E----?M----M------oE?-BooB-|Eo-oo--?-E?-XXXEM-?E--E|B-E-E-o|-----?---o?---?--?o--?--EXXXM---M---E-E----?M--------oE?----E-B-E?-o--M----X--------?------------o---XM-----E--|BM---B-M--------------ME
X----X-----E---M-X---?--B-E?--?X---MB-o----M-ET--------X--M---oX-E--------------B---X---T-M?-----?o---M---MBB--o---E-----T---M-o----B-EX-EX--E?o--E-M-BB----?M----o--E-o-o----?|---?B------XM--XB-B-MB-T
E--E--MM?E-----?-----B----?----------X-oT-B---X-?----Eo-X-?---------o---o-E------E-E-Mo-|--o-E--M--?-oM--------M-------B-X--------E?T--ME--E-o-E------E-------------o--o--X---ET--E--M-X---o------T---TE
oo-?BB-E-oT-M--T----BE------M-XB---B-o--|--T-X---E---o-----B-TM-?E?----B-M--BB---------M|--o----o---------o----T---X---TX---o-----EB|------T-?----oB----------E---------ME-----|--T-----T--M---o?-|---|E
E-MT-----o|---X|--TE---MT-----T--X--o---|--|-M---T-----------|-------------------T--T---XX--T--B---M-----------|------X|-------T----|---M--|----T--------------X--------X------|o-|-----|---------|---|-
m--|------|----|--|T----|---T-|T-----TT-|--|-----|--T--------|-------------------|--|-------|-----------T---T--|--T---T|-TT-T--|-T--|T-----|----|------------------------------|-T|--T--|-----T--T|T--|X
XXXXXXXXXXXXXXXXXXXXXXXXXXXXXXXXXXXXXXXXXXXXXXXXXXXXXXXXXXXXXXXXXXXXXXXXXXXXXXXXXXXXXXXXXXXXXXXXXXXXXXXXXXXXXXXXXXXXXXXXXXXXXXXXXXXXXXXXXXXXXXXXXXXXXXXXXXXXXXXXXXXXXXXXXXXXXXXXXXXXXXXXXXXXXXXXXXXXXXXX
