T-MX----ME-XX--XBMBE-?EMoB---M?oXE---o--MEM-o---E-B-M----EB--EXBB-B-o-?o--MM-?-MB---MM-XE-o-MM-oBE-Bo-X-E-BE---oEB?EXM-E-?M-oB--o-MEM-?-B?X-X??oBMMEB-X--?o?Mo-?EBo--MMo?X-o-X-o-MXX-?-oE-Mo?XBBE-??-o?|
X-??-BM-X-?o--X---XE--o?--Boo--BE---B-X--X-M-----BoXE---B?-XM--X-E?EE?Eo?-?E--o-B-?o--?-E?---MM-?---?---MM--B-T-B--BB---M-EB-o-------BMEoEoo--M?-EMTBM-?B-B--E?--EE?E--X?M-M-----B?XX-MM---XX-M-???-MM-E
--o--B?E?o?oE-----oo-MXoM-o---E-X---MX---?-B??--X?-?o-M---o?MoM-B--X--XMX--oEX-MEB?T-E-oMX--?X?---TEB---M-X???|Mooo?---Eo--Mo?B-E-X-----o----EXB-M-|BXoBB--o-Eoo-B----M----M---E-----XEo---X-BX---XX--B?
M-X--o?-----MBoM-o---?---E-X-X?-M-?--?----M----Eo--o--M--?----?-o---o----E--E--XB--|--XX----MB----|--?--------|XM---------ME------X-XE----?--?-----|MX-EX-MoTX-MX-E---E--o-------XEX-E-------o---EM--?XT
------o-----B-----X-?---XM-M-?--M-MX-----o?T--X?-E-?-Bo---M-----------------M-?--X-X-Mo---M----o--Xo--BE--X--MXE---o---------X------E-Bo?-o-X-----BXE-o-----|--E-o-MoE-XB--------------o--o---M--?-M-?--
|-o-T-------?T--X--oB--E?-B-----o---?XTEM--|----?-X-------M--B--B--B------T-?-oXBTX--E------------------o-----M-?-MB-------B-------X--M--B--------M-?-------|B----E-----------------M---o----oE-B------X
MEM-|E-B----M|---E---oE--M-B--E?------|--X-X-----M-M--B--E?--B-X----M-----|-B-E--X-??--M-?M-o-X?---X-----T-MoM--T-----E---M-EB-E----MM-------o-------?-?--o-|----EM?-Xo----M--B--X---XB--?--E---EBE----E
----|o-?B--MB|EM--ToMo--TM-----?--EX?-|-X----?-oX----------X-------?------|E-X-X-?-E-----ooME--EB------?-|-E-o-M|--------E---?X-E---Bo-------M-oEMM-o---oX-BX--M-MBTB---MB--?------B----B---E------?X?-v
EE?-XM-E-BX--X?---X?-?--|o----?E----B-|-E-?-----M-o?Xo--oo----E-?-------?-|-M---XM-M--B--o--TX-M--X-?B--BX----X-|-X?E---?BX----oo----MM--X-MBE--?B--------E--XB---B|----o--?------------B----?---E-----?
o-B-----?---M-----T---M-X-o-B-----E---X-?---oBE-B--o------?B?X-----X----M-X----?-------oo---|--Mo---B-----------|----------o-M----------E-M-MM---B---oT------------|-----?-To-X--Eo?E---EX--?-----?E---B
o--X---?---B-E-M?-XM?----M-M----E--M-M-B---EB--E---MX-B-o--M-E-X----?-T-----B-E--E--M-B--X--X--M?----B---?-EX--MXXo-ooXBXT---BX---?-BM----BB--------?E|M---X---?XME|---BT?-X--MM-----M------o-o-?----X-?
TMET--?EM----M--oo--o-oTM-X--X-T-----oT----EE-B?--M-M-M---?o-B--EXo---|---XE---?----E--M-T--E--?-------B-----X-?--E------X-?--EBB--XBE-o----M-o--M----XM---E--T?-E?X----X--TB---M----M---BMXT----XT--MM-
M--|---E--TB--o-M---To-|-----?-|--B---|--o----Bo-----M-----?-o---T---oXoM----M-----------|oo--T---------------?EM------------M--o-----M--o--?---BM------------XMoB-----X-?-|------------B--M|TM---|---T?
T--|----BE|-------?-|--|B------|------|T-M------E-----------?-X-E|---------M-T--T--------|----|------TMT---------T----T-M-----------T-------M-M-----?-----ToX-E----?------?|-X--------------||--T-|--T|X
m--|------|---------|--|--T----|------||------------T------T-----|---T-------|--|--------|----|------|-|-TT------|----|-------------|---------TT----------|-------T--------|T-T---T---------||--|-|--|||
XXXXXXXXXXXXXXXXXXXXXXXXXXXXXXXXXXXXXXXXXXXXXXXXXXXXXXXXXXXXXXXXXXXXXXXXXXXXXXXXXXXXXXXXXXXXXXXXXXXXXXXXXXXXXXXXXXXXXXXXXXXXXXXXXXXXXXXXXXXXXXXXXXXXXXXXXXXXXXXXXXXXXXXXXXXXXXXXXXXXXXXXXXXXXXXXXXXXXXXX
