?E?--X?XM-BME-EX-MB--XM-o-?X-oB?XX?-?-?EE?B-oX-EoME--MMXoXoM-Bo-M-E????-BoX-MXMoMo---EE--B-Eo?o-??-?--?E---EoBM-B---X--XXE--B?--XMMXMBo-Mo--?-MBXB-M-XE?oM?-EX?----X-BMBX-----??Mo--M-?XMoX-E--o---?---T
X-EM-?---?o---?-Bo-oX--o-EE-o--B---E-X-?XX--MM?-?-?----?MBXXo-BX--M-?XB---o-X-X?-?XB--X?E-E?XEX-E-oXB-oMEE-o?-X-X---MM-X?M-o-ME??MBB--E-oMXEB--??-M-------o--?oM-B--X-Mo-E-----o----E--E-o-B-o-BXEXEo?EX
---M?----oX---XooM----X-oo--MME-oo--XM?--?-?-B-X-XM----oE-E--M-oXB-----?--EMMB--o---??-EoM?MM--o-EE?-E?XX-M-B-MX-oo---E---o------M?-EMB-E--E--??o---M-MM?-E?-B---XooM-B---E---BB-?M-E-X-BE-----?XM-B-oXo
B-B--------B-----?-M---o-----M?M--B?--M----?-X--M------------?--XM---?MM-------MM-?--oBBB-o--oE--oEB?--X--oo-oB-XE-----E?-------oE??-M---X-o-B---o-M----o--------X?------T---?-ME-MX?-------E-?B--E----|
---MB??B---M-?E-E----o-------B??--TM----E--MEB-?-B?-TB--B-M-?-B---X--?---X--------T-----?-M-M----M-----T-o---E--E-?E--o----------E--B-?XEB-T??B--?-M-?----?X--o----E---EMX---BM--o?---X?--?------oMT-M-|
|-B-?--M------E-B--E------X-----M?|oM-?---M---o---?-|o-o--oM----------MX-----B----|-B----?--M---?--X-MMX-----o-----E-BEX----M--X-B-X?XET---X--MM-M?------oB------?--X?E----B-M?M--o-o---M-ET?-----E|---X
X-M-oo-o--o?-T--B--?-E-X-BM--o--M-X--X---o-B--B---?-|----M---X--X-X----M---?------|X-M--o-B--B-B-?---MM-?-B-------XE--B-X---E------o---|--X------o---o-B--M-X--M--T-MBB--B-?---M---M--EB---|E-oX---XM--T
B--------B?--|X--o--X----MoE--X?-o--M---o----BM---B-|--M-oX-----------X-B----M-T--|--BX-BB-------o?X---E-B----X--X--M---o-----?-----oo-X-E---BE-X---B--?B--o-----?|B-E-----MT----oB---M---oX---------E-v
----?X---?T--|-?-----oB-?-----MEE-X--??o--M--E-oX---X-M-E-E----E----M---?B--M--|XEX?-o--B-E------------E-B--E---E---Mo?X---MEX-----o-EX--o--?BBX-B----o---o?B?B---X-E--E-BB-X----?---T--E--MX-o--B--M--B
M-----o---|o-X-?--------E-------o--XE-o--?--E?--B---EB--M---------?-BX--o-XB---|--T?-M--?-Boo-------X-X------XEBM-?Bo-Eo?-?----X---------B--oM----B-B----B-M--?----?--------oXMME--XM|-?-EEo-?MoXMEoE--?
E-M-o-EE--XoEB-M--?--o---?---M--EE?--??---?-ooE-?---BE--Mo----oo----M-B--X-----X-BX---X----?--X-B--M-----o-E-------------?-E---M-BME--o----------E-X-XM---o---B----?--E-B--M-BB-----B|X--E-------E-----?
T-----T--??-----?--?E--?T--T---X-EB-o-E---o-B--T---X--EX--X---------T-M---X------o--T-TMXX---T-oM----E??o--T-o--TE--X----o---M------X-----?oBT-?-----------ME-?---M--XME-E-?----?T---X----E----------X-B
?-----|-------M---------|-o|----?--?----oT-----|-BMM--BMT-----------|---BMM----T-E--|-|??--T-|?------o-----|--T-|--M----oT-T----------?---M--X-----M----E?--T---------To---------|------X----X-oXB------
oXE---|-----?--TX-----T-|--|----T--------|X----|--------|?--o--M----|-----T----|----|-|----|-|-----?T------|X-|-|-------T|T|----XE---T-T-M-MT------?-TE--T--|T--------|o?----T-X-|-E--T----------------B
m-----|--T-----|T----T|-|--|----|----T---|-----|--------|-----------|-----|T---|----|-|----|T|------|T-----|--|-|T------||||----TT---|-|----|--------|T--|--||--------|--T---|-T-|T--T|----------T-T---E
XXXXXXXXXXXXXXXXXXXXXXXXXXXXXXXXXXXXXXXXXXXXXXXXXXXXXXXXXXXXXXXXXXXXXXXXXXXXXXXXXXXXXXXXXXXXXXXXXXXXXXXXXXXXXXXXXXXXXXXXXXXXXXXXXXXXXXXXXXXXXXXXXXXXXXXXXXXXXXXXXXXXXXXXXXXXXXXXXXXXXXXXXXXXXXXXXXXXXXXX
