?E--Xo-?o--X--B-?----XM?Bo---XoXB----EXMB--?MEE-X-BBoME-o-M?-BXM?-M-Xo----Mo?-Eo----?BoB-XM?-----o??B?---MBo-M?-o-X-MXX-XXE--oXE--?--XX--B-M?XXoB-X?-B?M---E?X-M--E-MB--M---B-B---EX-BXX??o-M--BMo--XBBM
MB---Eo---oE-X--MBEX--B--BM-BBoBoBX---MB------EB-M--?M?Bo-MB--BX-X---o--EBX--BoE--BXB------BM-EBM--XM?B---E-E?B?MXME-------XE-Eo---B-oEE?-MX--MXBE-???X--EM-?o-o-MMXo-B-E-BoMo-oME--?oo-XMX-ME--B-BXoE-E
BoEEEo---o----XME--Xoo?X?--?-EB-oMB-?---MM?o--M--oMBMMBE-M-Eo-XMMMBB-M--MMB-XMBMXoXE-E---o-XM--B?X-??MEMoX-M-o-oM--o---Eo-B-?--?-M-B-E----EMBMXX---BX-XEXX-?E-oo?M-MBXM--MX?XE--?EM---E----X-B-M??--?---
o--E--o--E------X---BE---??X----oo--EMBMX----X---X-o-oM---XB-B----o--B-M--------M-M-oXoM--?-----M-----?EB------B-----oB-o---?X?--?-MBXE--------------?---ME-oMM-o--oMo?---?-------XX--M---------?E-B--EE
-E-M?--B?---?X--EXXM--o-EM?----M--X-EB----M-M---B--------X-?Eo---B-XX-XBMM---?--MB------E-E-B-o----E-E-----XXM??----?---B-M---M-o-o-o---E--?--B--o-B---BM--XM-E--B------?--X----B--o---oX-------?----?MM
M--BB----EEM----E-M-E--o---E----XMoX-?o--XBB---ME--?o?----------X?o----MM--E--X-----Xo-XB-Bo-M---MX-X-XE--B-----o----??--?-o?-MoE-B?----M-E?-X-oX--oXB----?B?---X-X-E-oE-?-------BoB-B-------X-o----M--B
?--?---B--o?M----------?E---X---------B-M--------?-?-MXXoMMo?---E-----Bo--E--oEX----MB----------XB----------------XME-EE---M--E---?-?M-M?-E-ME-M-----B-M?-?----E-o----------B-oEM----E----M?-o----EM-E-T
X-MEXEo-XXE-o-E-BBX-E--M?--X-XoM-Mo-?E---o--X-------E-o-o------X?--BB---XE----?--X-----o------o-E-XE-X?-o----M-M-XE----M----T-??E--M--?M?--M----BXX-E-------o-E-?M-??---------Bo--o----MMo-BoBB-?X?B?o-v
--BE-B-M?--M-BEM-?-MM-?-E-M-X?--B--o--BMM-----X-------?--B?---E?M---oo--B--X-----M?B-E--------B--XM--E-----XB---?--o?XMB?X--|---BX-E-X-E------------E-B--XM----o--o-E-?E----BX--X-----o-o--o--??o-----?M
X--BM-T----M--B----?M------E--Xo?-------?M?-X-M---------BM?--o?---?B-o??-XX-X--B--?----B-------XEo-?-----?X--MB-oE------o---|?-XME-?-MX-X--E-MEE--MX----M------B-----------?-EBX--EE--Bo----o?M---E--M-?
X-?--M|-MM---E--X-?-----X--?BEB-E--------o---BoMM--?--M---B---M-EB--M-M----?---B-BM-oo-M--Eo-??---E-?XM-B--------BE----M---BX------------XMoB--EooMo-B--o-X-E-E-EB-----E-E----------M-?-X?--o--X?M-----?
EX---BX---B-----B--X---BEo----BM-----EX------o-----M-Xo-X---M-B--TB--B---?XB--E---E?Bo---XM--oBM---X------XT-B-o----BM---TMB------M-?---Bo------o?-MXBM-?------?-BX--X-------M-----X-------M--o-E-Mo---|
|B---o---X-o--------M-?-------B---XXT---o-----E-----M---o-T---o--|-------E---E-?-o----------o------M-?-X---|M-B----------|-E---Bo-?-M-------E---o-MEM--E-oE--EETBE-E------------o-M-M-----B--------oB--X
T--o---T--EB---M----M--E--E--------B|-E-o?--M---X--E??----|------|oX--B---T--MB----BTM----------oXX---BooM-|B-o?--M-E-B-E|----o-o--o--B----M------E--??--o--?E-|-M-------------oB?BM-oM--M-----E-T-----M
mT-----|----------------------------|---------------------|------|T-------|---------|----------------------|-------------|-----T-------------------------------|---------T---T--------T----------|-----o
XXXXXXXXXXXXXXXXXXXXXXXXXXXXXXXXXXXXXXXXXXXXXXXXXXXXXXXXXXXXXXXXXXXXXXXXXXXXXXXXXXXXXXXXXXXXXXXXXXXXXXXXXXXXXXXXXXXXXXXXXXXXXXXXXXXXXXXXXXXXXXXXXXXXXXXXXXXXXXXXXXXXXXXXXXXXXXXXXXXXXXXXXXXXXXXXXXXXXXXX
