o-E?--E-E-o-XX-o-XEXo-?M--X-XM?BE-B-ooBM?M-?M?XE?-XEX-M?EM---oB-oB?o?EoX-X?-?--B---M-?MoMo-M--X--X----o---M-o-oXXX--?X?-o--oXMBM?M--XMME-X--------XBXBoMEoE-X----o-E-ooEXM?oBEM-BXE-?BX-MoE-E----XB?MX-M
|M-EXX----E-MB-MBB--X?E-M--X-ME--MX--oE----EXM-B--BE-M-?B--EBXo-EoE---E-?---?B---?M--Bo---B-B?--M-EEX-BE?--Mo-BoM-oBEX-??B-?Xo?-?--B-XX?-o-?--o--o?-?-XM-BE-XEMX-o?-MXM-BE--o--M-Mo----E?BEMMoXB-E-?E-Xo
X-B?--B----BooB-X-Xo-----XBBM?-o-B-?----X--XE--E---oM-----MXB-o---EM-X?-?-M-oBM-XE--M-EBE?B--B-E-X?E?X-o??--?----Eo-----?-BX-o-----X---X-----MXX-EX-M?T-?-MoB---------E?-o--X-o-------MMM-o--MX-?M-----?
To-----B-?--E---BM?---?---o?--MXE-------B-o---B-EX-X--EX-------T----T----o--X--?---M--E-o-B--------X?---X-----B-M--------XX-----oM-E-----T--Mo--------|-B-------M--??---M-M----X?E---o----B--X---------|
-B---X-B---X-----o-?o----B-T----M-----XB-X---?E---o--oo-M--XoM-X--X-X?M--MB-?--M-XEo---B----B--X--oo--o---X--X----B-M-----o----EB-MM----B|?--?-----X--X-M-?-MM---T-----E-X-MX-B------?---------o--------
--o-----o-o----BE-M-o----TXX-M--BB-?o-----X-?--BM-------Mo---M-M-o----M-B-o---B?o-E--MBBT-M-----M-M--M-------M------??X---?-B-E-o-B------XB----X-----X--MBo---MB-X-------E?-------M----E?XE-?B--EB-?---B
M-----?E-----??----?----oX--EBo------------TE---M----?------?------X-o-?-X--M-------E---X----------TEB--M---?-----X---?-E-M---B----E-X-------M--X-E---M----M---M---------o-o---------BB-E?-XEo---B-?o--|
oTBE---o--XEB-----B--M-M-M---BE----B---M--BXE-oEEMo-??B----M-o--X-?---B-M-X-?----X---M---oM---o---XXoE--M-B--?----o-?Eo-------o?--X?------o---TB----X-M-----B---X--?M------M---M-E---?--------?---E----v
-|-------------X---o?-------?o------?-B----M---E-o---BB-?---------B-o---?B-M----E----o-o-------EBB-B-MM?-E-TM--?-?-o----X-X-------M-----X----?|----?----------o-----M-M-------o----E--B-?----To---?X---X
oX----M-?---------------EMo------EM-?-E--X-?--------------Eo-?--BM-----E--M----XTMMBBoB----?o--M-M------o--|-X---E---?E-?E-??---X?TMBBT------BX-------?-E?-M-X-----?-----E-E-M---o--B--E-E-EMX--?-BB-???
T------B-MX-X----o---T?oE-oE?-------?-M--E-B-XBo--X?----o--?B-X--E--E-o-----B-E-|--------o--M---EoE----X-o-X-M------B-M-?B----E-oMXE--|--oE-X--o?---B-E-EM-?------B-B--oT--B?---E-----E?----?-oX----B--|
E-?--------X-------E-|--?---T-X--X---o--MM--X---E--EE?T?-----?M-M-ME--oM-------TTE---?---------E?o-B--M-?-M-B--T----?-----?---B-Mo---BXX---oo--------ET----o-----E-E----XM---o------E----o----------T?-o
E-M-----B----MM------X-M-M?BX-M-----E--E-----T------M-|---?--?-------------E---||---------M--------E----o--E-E-|--o-o----E-M-B--T----------E-----o----|-T---X-B--------X---------?o---E---T----X----|--M
?-----------T-TE-------T--------M---TT-TT----|T-T--TET|---------X-?--T---TT----||--------T-------------M--o----|--T-T-----X---T-|-----T-----------T---|-|-------B-oo--T----E--------------|----TT---|TT?
m-----------|-|-------T|------------||-||----||T|--|-||-TT-----------|---||----||-T---TT-|------T-T----T-T---T-|--|-|----TT-T-|-|--TT-|----------T|--T|-|-------------|--------T----------|T---||TT-|||M
XXXXXXXXXXXXXXXXXXXXXXXXXXXXXXXXXXXXXXXXXXXXXXXXXXXXXXXXXXXXXXXXXXXXXXXXXXXXXXXXXXXXXXXXXXXXXXXXXXXXXXXXXXXXXXXXXXXXXXXXXXXXXXXXXXXXXXXXXXXXXXXXXXXXXXXXXXXXXXXXXXXXXXXXXXXXXXXXXXXXXXXXXXXXXXXXXXXXXXXX
