M--X---oE-M?-?EoX-M-B--?-oE--o--?M?---o-oE-B-?MBE--M-E--B-?---M--X-oX---??-BMB--o-EB-B-?Mo?M-?B-B-B-M-M--B?ME-ME-MB-MEo-B--E-X-?XEB--E---o-XM?--EXX-BMM--BM-X--MEo-BB?-o-oB-o-XEo-oooMM-E-B??--B--M?-o?M
XMB-XE?-M-BEEXoB?E--o-M-B?-BoE--Eo--?------M-o?-Boo?--BMEEBE-MB----??--E-ME-BXBE-BEEE------M?M--?ooX-M??B--?E?o---B--oB-B--E?X-M-o-EE-?-?-X-X-o-----E-?-EEX?XE--XMMX--oXo---E-EB-M?-M--X-MX-EE-oX-----MT
M-M-??---XM-E?----?-M--oEM----?E-MM-ME-?---B-??-------X-ME-BBXB--E-E-MoBE-Bo--M-B-o-XE?oo-X-EM--?X-BBME?--Mo----oEBBEoBB---------EMM-B?-?--B---M--Xo-X--E?-B---Bo----o--B-BEM?B--o?--oo?-o-MMEoMM--??EE|
MX---X-----E-B----E----o-?M-EMoB--?-B--M-E--B-o-------B----o-?----?---BM-Eo?---M---B----o-??-o-M----BB---Xoo--B---EXE-?------?X-?-E?X-------B?-o-EBE-M--------B------B---oM-B--o-X--BB--?-Bo-X--MB-o---B
EE-o--?o-BX-o--XXE--MoE---Bo-----E----XB---XB------X-o--MM-EX-oo-BMB-----BEMM----o-M----?---?B--?-X--o-B-------M?B--M-BEM--o----B--E-----B------M-B--?ooo?--EE--Xo-?BB---o-------?B-o--X--E-BEM-ME---o-?
T-X---o---B-EX--B-E--TB--E---------XBXE--XE-E-B----E--o-----?E-B?-----XX-MMEB--M-B---MoM?--M-E--?X-E?--------o---B?o-X--?-------?B?-?o-----BMo--ME?M-MB---M-M----o-oB-------X-XoM-EX-o-?-M-?---M--B----T
B---B------M----ooM--|o?--Bo-M-X-E-?o--E-o-XM-------o--B--B--MB---M----M-?-E-X-E--X---o----o------?--oE-?--B---BM----BX-o----E----o-------?--oE-B-?B----------E-------M-o-X-EE---E--Xo---E---X---o-T---B
E---o---Xo?--XT--B---X--o-M---X---Mo-----o---MoB--?---?--E?--B-?MM---E--X?E-X-----BB--MM----X-X-?o-X---M--EE--B---o--B----M------BM-------M-BM-M--o--------?MoEXB-X---?-?--?-M--M-----XB--E--MoB-M-X--Bv
------?-?--B--|-M----Bo-B?o-M--BXo-BX------E-------MBB--?---Bo-----X--o-B--o-o--M--E--M---X?--?------------B?--o--B--?X-?--B------o-----XBMo-BM-MXM---X---XB----M-?-E------M-------B--Eo?---o---M--?--Bo
X------X-----TXMEM-E?B-oB----B-------M-M-----BB-T-?-M-B--------E-M?B-----?-?B--?---M------o-B---E--Mo?X-?-----ME-o-B-E--TMM-BM-M---XEoM---E-?------?X-B--E-o--XB---B------BBM-M-M--?-X?--BMoB------EX--E
|-o--M-B-o-E-X----------BE---Eo----MEB?----?X-EEX--M-----XEE---oB--BM----EM?-M-------MXB-E-oo-B--B-----o--?-EB-------??-X--B----MB-o-o?MB---ME-------?--X--------MMo--?----o---E--TM-------B--E---E-M--M
T-B---X--E-E-BEX---------o-BEo-----?BM---X-----E-M--E-E-o---?--B-----M---E---oXM---X?B?---o-------M--M--?-M---M---X--B?o----?---B?B--MM---M-ME-----E----o----?--X---o----E-------BX?--?--?--T----------B
X----X-X-Mo-B-----o-MX?-o--o------o------o-----B----?----B----B-M---oB-M----?E-EX------B---?M-------E?------------M--B---o-----ET-----B--X-X?-?--E----------X-?-MB-E?--M----XE-o-E-oB--X?-?-|-o--B---X-o
XoM---M-B--?MM-M---?T-?M-??---BTMX-----?-B--------BT-B-o-?---------?----XB--E-------E----BM---E-?------B-----o---T----?---------|-M-X---E----o?B--E--T---M-o-?BM---oM?----oE-?----B-B--M?---|--------ooX
m-------------------|T---------|-------------------|-------------------------------------------------------------|--------------|-T-------T----------|------------------------T---------T---|----------E
XXXXXXXXXXXXXXXXXXXXXXXXXXXXXXXXXXXXXXXXXXXXXXXXXXXXXXXXXXXXXXXXXXXXXXXXXXXXXXXXXXXXXXXXXXXXXXXXXXXXXXXXXXXXXXXXXXXXXXXXXXXXXXXXXXXXXXXXXXXXXXXXXXXXXXXXXXXXXXXXXXXXXXXXXXXXXXXXXXXXXXXXXXXXXXXXXXXXXXXX
