T-----EXM--M-M---o---?XEE?XXo--ME?-?-BBEE?XB---XMBE--oEE-??BX-E--oMBXMB-X----o-E--XM-----o-XBME-oMMBX--X-MMBoM-oB?XoBXo--X-?---E-XB?-EME-E-EM??B-EEX?B-o-??o-oB-XoBM??Mo--???X--M--BE?-?o?--E--BMoM---E-
?-o----MX-B???-Moo-oo-XB-o-M-E-?BEoM--?X?---?Xo--?EM-M-EBEE-XE--BX-M-oo-BB---B-?Xo-EEo-X---o--?-EoX-X?BoBBX?----B-E--?-B?-E---MB---o---X--E-B-B-?M-MX-X-?-o-BXEX-E-?o---X----BE---E?--oX-MXBMMB---XoE-Bo
T-??XE--MXEMB-B-o-B--E-?-XoM-oEMEX-X-XM-Bo-MX--?M-MX-E--Eo-B?--M?-?-?MEoMEB-M?-BEE---E--?B-M-?-oBBE-E-oBXoo--E-ME?--BB---MBBB--M--o-MBM--EoM--Xo--??o--X-MB-?-----?B-MMEX-B?B?--BBX--B--o-EE--XE-BB?XoBT
|-Eo--M---oo-XXo-o-----------o-------M---B-------M---BM---M-B--X----B--ooXX---B-----o--M----?--ME-??-B----?-?B-----?B-M---Bo--M-----?BX-M?-o-?oM---?-E---XB-o?-E------o--M-EE-BMoM--BBM-X-EBE-E-?M-B--B-
TE--BXB---B-M---?--M------?----E--?-?E---MMEM?o--------o--M----??---MB----oE---?----B--EX--X-------M--X------B-EB-E?EMMo----B---B--o?-----B-------B---M---o---XM---MM?TM-B-?Eo--M-XEE--MEEM----E---?T--T
X-?oE-----EM-----Bo-?--o-------MB?--B-----B---B-----EM---M?-o-X--M---Bo-XB---EXE--------o--?---B-B---o-X------M?----o-MM-MM-oX--E--B--M-----M---oB--o--B-------oX----M|-E-MooBE-------o--M---o---?o-XBEB
E-----EM-B---M----Mo-------o---M---M---B-o---EoX-------E--o---E-?-o--------E-----?E---E-BoM-?----o--M--------X--XEXB-----?Bo---B--B?---M?-----?o??-B-------o-X?-M-?-XEX-B--E---X?-B?-?-o-MB-EB--o---?--T
B-Mo-----?o----M--MEMEE------B-?---?M------X-E------?TX---B--T--?XBooo?B-?X-B--M----?---?M----E-EB-X-X-M-Xo-M---o-?-XXXMo--MM-M--E-B-M---M?B-----E--oMBB-------B-???-Bo----oE---B-E--------?-oo-B------v
BBM----?--B---EE-Mo----?X-M--B?--?---B-oTM-E-E-------|o??---E|E-M-o---E?BM-----B--M--------M?--M-B--M--B--E?------BXBE-M-XE-B--X------X----?---------Bo---M--BoE--M-BB----XEoB-TBE---o-X--MB-?-------E-B
B---?--?-X?M-EMoBo---EX-MEM-X--M-------oX------o----BXM--o---|M--M-M------M--B-------?--Bo-MEX-----XE------BBB----------X-----MoB-M---?--o-B--M------T--M-------E--E-o--B-MM--oX---X-TBME--B?---?--B--MX
TX----o----E--BB----B-EB?--E---o---B-??--?-X-Xo-TB-----oMM---|----X-----E---?-XoE--B-B--E---M-B-----o-X-X----oM--MM-MMT-----M-TMM-EM---B?EMoX--XXMXo-X--EXo--X-?E-o---o?-E--?-?-E-o-BX-B--o----X----Xoo|
|-M---M-ME-?M--E-o-B--M--E-EEE----??--E?--o---M-XoB-o--M--MBEX-X-------o-?--EE-----?-?--EMB-------B?-?-X-MoM---o---XMM|Xo-M---X?E---M----?------o---ME-XBB---?--BBoo------EE-----?-M-B--E-----B--?MM---M
X--o-E-------EooM-X--?-------E-M--B------??----MM------EB-----B-----MM---?-M--M?-BEB-M-Eo-Eo----E--?--X-o?o-?----?---?-?E-B-BMo-o--EBEXM----E?---M-----B--X---o?--MM-----BB---BoE--E--------X--X---B--M|
E-E-M--?---BEooB?---XB-o?-B--?---E-----oE-E-oo-----?M-o-M?----?X-X--?-o---o-o?o-E-----Eo---M----BXM--MB?----------o--?X-M-------B-X--o-M-M-B--Mo--Bo----o-?----EM----?----E?--------EM?-----?-X-T---EMMX
mM-X-BX--E-M---MoX-BM-E--MXXo-EXX-E--XX-oM---oB--E---o-MBMEXB-???-X??XM?MEEX--?o-B-XoBo?--M-oMEo?-BoMM--M--EM--B--oB?-MoEE-M-----E-E-BEoE-oBE?-XXE-o---o-X--E--M-oME?oE--oEBMM--X-E?E--EBMXXE--oXBo-BM-X
XXXXXXXXXXXXXXXXXXXXXXXXXXXXXXXXXXXXXXXXXXXXXXXXXXXXXXXXXXXXXXXXXXXXXXXXXXXXXXXXXXXXXXXXXXXXXXXXXXXXXXXXXXXXXXXXXXXXXXXXXXXXXXXXXXXXXXXXXXXXXXXXXXXXXXXXXXXXXXXXXXXXXXXXXXXXXXXXXXXXXXXXXXXXXXXXXXXXXXXX
