MEB-?E--BB---?--XoEB?--EoEX-MM?o-oX-M-E-Eo---?-?-BEXMoEB--o?MXM?MB-X-?-?X---E?M---B-----B---MX-BMo-?E-M-oXXo-oB-o-M--o---MMEEE-?ME-X-o--XoE?-o---EBB-X--XE--X-oBMX-EMB---X--BoE-oE?E-B-----MBoEMX?EX-XXE
TMoEX--MM--B---XoEo--BB-E-E?---?-MMMMoME----oMMBMo-?---EB?---B-E?E?-M----B----XE---M-EM-o-XBo-?--Moooo?-X-E-?XB?--??B---E-M-----?B-----o--EoBM-B-MM------M--XBXMMo-B?XE--o--oM-MoB?-?M--B-o-?-EB?E-----M
M?X?oE?-ME-MoEB--Boo-ETB-B----?-ToM--MM-E-?Bo-B-E-MBM--MX-?T-M--M-----------XMEX-oM--o?-?--E----M-?-?M-EX-M--XXB-EBE---B--EBB?-XX---o----MXB-EX?-MM-EMo?-?----BBX--?EBM-?ETo-XEE-B----?o-?o----?X-MEo--?
BB-B--B--------T-?----|E------B-|BoBoB-B-TB-X--M-------oX--|-------oX---oB--o?-?------EB--B-BB--------B-X-?--o----X-TXo-B-----o-X-B--M-------B--------?--o---o-E---MBEE-B-|-?B-?E-MBX---M---oE---oB--XTX
E-?---------X-M|T-?---|-MB------|--------X-o--o--B---o-B--BX----?-XEM-oX-MX-EM-T?---o---oB---M----T--M-M---B-MX----?|-E-----?----E?--BXB---?--------E---BE--XMMTX----?---XXB-E--?--------M-M----------|-
-EMX?--o--M---BX|M--E-X-----M--E|M---B--X-----oT-T--T---------B---M-M--E---X--M|TME?T?-----M-o--?-|E---E---BB----o--|o-B----?---o----M---MX-B--?----------?----X------X-----X-E-?o-MX-?-----TX-M--E-?-X|
?B-BBo-oo-?B---o|-oo--o-X-M-M---XEEX--M?-E-Eo?-XX|-E|---E--?--E---o??oM-B---?--X|--M|-----BB----o-|----o---?----MM?-XE------?XX-??---M-BXMooEB-MXo--M----B-T------E----?X-----?-ME-M?--BX---|---Too--EEB
MB-MB----X-----o|--oME--------EE-------o---------XBoX-M-------T-M-----M----M--XM|-?EX-------BXT-M-|-o--E-X---oM--ooX---o--?---BB--X----?---EM?X-o---M--ooo-|-oE-----X?-------------B--------X-X-|-?-M-Mv
M-E---B----E--?-X----B----------X--?B-M-T---BE--B-------M-o---XB--M--M-BX-Xo?-?-X----B-X----TM|---XX?-B-?-----o-B------o?-EM------------oT-MM-?-?X--?-MM---X-B----X-E--B--------B---M-B------?E-XE-----|
|BM---T-E-B-T-o--TEooE--X-o-o-Eo--B?--B-|----BM--------MB-----B----X?-----MT-B---X?---------X-X------BEM-oX--ME-oTT?----MB-M--X---------E|---------M--E---o---?X----------M-----o-B-EE--B--------?-E?-B|
E?--E-X----?X-B-o|--Eo-X-B-------X------XE--X------E-------oXBM-X--o---BooB|-?X-B---B-----E-E--?MMM-X---B---?-B-o|X----?---E---?-M-E---X-|--o---B---?-M-E?--BB-?-B-----MM?--o?--M-EB?--M?-X-M--?-?T--?-T
X?XX-E-?-T-----T-X---Mo--EX-BM--M-X-----T-------XX-E?-oB-?Xo---------TT---TXT?B----EToT----?---TT--?--------T-E-B|---M-ME---BM-B---oB---MXE----------------E-----M-o-----------------T-----E-----oX---T?
o--------|X----|-----B----------M?----T-|----X-EE---o-BB-?-----------|X---X-|-B----B|-|-----o--||-----------|----X-----------M------E-o-E--oo---o-------o--??---o-E--?----------B?---|?------X--X-E---|X
--------B|--T--|-X-TT--?-T---T-TTT-T--|-|------To-------T-T----------|------|-T-----|-|-------T||-------T--T|--M---------------------------T----------------To----------o--B---T-----|--------T-------|B
m--------|--|--|--T||----|---|-|||-|--|-|------|---T----|-|----T-T---|--T---|-|----T|-|T------|||-------|--||----------T----TT--TT-T--TT---|T-----------TT--|---T-----------T--|--T--|--------|---T---|?
XXXXXXXXXXXXXXXXXXXXXXXXXXXXXXXXXXXXXXXXXXXXXXXXXXXXXXXXXXXXXXXXXXXXXXXXXXXXXXXXXXXXXXXXXXXXXXXXXXXXXXXXXXXXXXXXXXXXXXXXXXXXXXXXXXXXXXXXXXXXXXXXXXXXXXXXXXXXXXXXXXXXXXXXXXXXXXXXXXXXXXXXXXXXXXXXXXXXXXXX
