?M-oXBM?M?--MM-E?o--MEBoEE--Bo-o-XX-----?XBMBB-MX---M-?X-X-EMBB-B--MX-o-EooME??o--?---E?-X--??MBME-M--E-o-E---E-EM-??EMX----XB--o?BE---M-X--XoE-?E--ooBo--XBB-?-B----M?M?M-BM-?o-EoXE---?EMM?B---XM-B--E
M-B--B--M--ME?---E-----X--o-M-oMo-?M-M--XoMMMEEo-o-XM--E-BM-Mo?-B---BM--E?oMM----M-MXME-?Eo-M----E-BX-?---E?M?B?-B---M-M---oBEX-M-o------XBM-E--E--oB-XB--EM-MXo-?----B-MX------EB?M-EMB--MBBEBE-XM-?MBM
TBoM----?-??-?--TE-o--X-E----M?-X?E----BEMX-B-M-M-X?-B--?---X-M-?B-X-Bo?---M-XEM?---oBBE--B-M?M-M-E-----oX-oX-oX--T-BBET--EB?--MoMo-XMX---oB-XBMX--Bo----TBo--?XoM-o-?-E-E-B-o---XX--o---?o-?-Eo-M-oo--?
ME-o-----BM-o?-X|MX-MX---E----o---oX---?-----M-M----EB-----M-?-E-o-------------M---?-EMBB-----oXoX-----o-X--M---B-|--B-|E----X-----o------M---o---MM?o?ET|BM--M-o?-X---------XXM-MTET-o---------B-?E---B
T--o--?------?--|B--------o?XXT-E--oT------o---B-X---EoEB-M----o-----B--E-E-?--EEEB------oB-----------M--ooE---B-oX-X--X-M--E-----o---------XX------?---XX?-Eo---M------T--B-B---M|E|-B---X-E--o--MoE-?|
?--?--B-E-X-?o-EXBEX----?-?--M|T----|oM----------o-X--BB-?---------------T----------X-?EEM--M--X----?-MXoBM--X----M----------XE-B--XoBM-E--X--B---B--E-----E--o----?----|M-------MX-|----??--E----------
-M-?-o---XMM-B-oT-----Moo?-?-B|X?B--|-----BM------MB-M-B-oE--B---?-o-o---X?M-?M----X-o-------E-o----MX--?E---M------X-B------M-o---?--?--------o-E--o--------M---o-----X|--?-?--E-o-|-X-B--------o-BE--B
?---?---------M-|-----BMoT---o|--M--|----ooB-o-BB--------------B--------?----M--Bo--X?--E--?---M-EM-------X-??-E--?B-E----o--?B-?------E-M----X-B-----?---MB-B----B--EM-X--B----B---X--B--?--X?-EE?----v
|?------M---M---X------E-|BoB?XM-B--X--M-M-------X-?-B-o-----EE-XoXX?---B--M-MX-----o?X---E-EoB-X--?------oE---B?---Boo?--?---------X-?-B---?------M--oo---B---XXM---B---o--o-oE-----X-----X-BMBM---X-oM
E----X---X----oB---o---?-|E----o----BXMM?----o-----M-B----E-------BBB-?----------BE--M--o---oo-Mo-M-B--E--MM---o----ooM-BBBX?--Bo------BE---Mo--EB---B-M-X-?--oo------M----?--B--E-?--M--o--E----Xo-?B-X
|--X--?-----M--Eo-X------XB--?--?MM---E-----------E?E--------B--X--o?--E---------T---Bo--EEXE-----oB?--BM---EB-M----BoB?B-----M-M----o--o---E----o----------------BB--MEo-----M?-?o--X-BE------o--?--o-T
o---------E------T-----oT---------B----M----?T------B------E---M-----o----o------X--M----M--------T-?-----o-T----M-E---T----o-------T-------E--?-BE--o----B--EBB---o-E------E--?-------E---Bo-E?EX--MM-X
B--?--X----o---?-|---o--|---B-----TM---------|----T--B-M-----------T??--E------?-----TT---E-T----B|-B---X-?-|T-B-?--?--|-X--T?---?--|oB-----oXX--?--oT---?--X--B----T--o?--------TM------E-?MM-T--oE---?
o----B-o---------|T-----|---T-----|------T---|----|----------------|-----------------||T----|-o---|---------||---------|----|-------|---MX-----T-----|-----------X-o|-------o--X-|--E----T---o-|-------o
m-T--------T-----||-----|---|-----|T-----|---|T---|-T-------T---T--|------------TT-T-|||----|-----|--------T||---------|----|-------|----------|TT---|-----T--------|-T----------|-------|-----|-T-----o
XXXXXXXXXXXXXXXXXXXXXXXXXXXXXXXXXXXXXXXXXXXXXXXXXXXXXXXXXXXXXXXXXXXXXXXXXXXXXXXXXXXXXXXXXXXXXXXXXXXXXXXXXXXXXXXXXXXXXXXXXXXXXXXXXXXXXXXXXXXXXXXXXXXXXXXXXXXXXXXXXXXXXXXXXXXXXXXXXXXXXXXXXXXXXXXXXXXXXXXX
