?-oE?E-M?-M-MEBBM-EX?--BBXE-XB-M??XoB-B-?B-oXBM----o-B-?-?B?X-TB-??o-EBM?-?-E-o-?--X-EEM--B---oX-B--oMMXoB--Boo-M-o--?XBBEoo-XMM??-XEM-MX-?-Mo?oMXX-?--?-EB-o-?X-E-B-ooXMoo?--o-o??-?--X--BEE-o---M-BoBM
XBE-?----MoX--?-E-o-E??-XB?---BXE---X----E-?B-M-ooBX--XB--MEBo|--?-X-o-E-X--MEo-o??-??X---B-EMo--BM-oB----Eo----B-M-M----B?---EM-E-M--B-?-B?oX-?MM-M?-M-EEXMB---o-o?-o-B-MBE--MEBXo--?-XB-BEEEEM--EMM-M?
--Xo-o?-MXBMX-X-oE?BB?XEEX-oB-----B?o-E-E-Mo-MX-EB--E-?-M-EM--|EM-E---E-B--E-X--------X-M-XME-M---XoX---?XXMM-o-MBM--E--MBE--B?-M-X--?XEB-MoXBB--EE-?-?E--MB-Xoo-?--?X-B-oo--EoX----B-MM-B--oEB-MBo?EXX|
o---Eo--B-o?-o----E-X-B---?--E--E--------?o-------M--E-o--M---|---M-?--E-B?-XE------M-?Bo-M-?o-Mo--o--M---X--M--o---------E---E--------B--o--M?-XE---oo---M--------EoB-?B-M-------o--E--------MM-?--o---
?--BB----?E---ooX-E-MB-----------E?-X-------M?o-E-------M-?---X-M--B-X--o-BM-----?----E---BB---o--E--E---BB?-BE-?-EEMM----B-E-EB--E--M-------M---------M-?----MEB-X-oBX-E----?--EME-----?E---?ME-------|
-B-o-M----B-oT----E-?----------X---MM---------?-o?B--------??------------oMBo-o-E-----B--------?--B?--------M-?--B---M-----------X?EE---------EBB-M-oX-----o???---TX-B-?--------M-o-----ooX---o-X-X--E-X
E--o-E-X--Bo-X-B-------X--o-----X----?M?M---oo-?---o--?--o?----B--E--M---M-E-BB-MX----BoBo-X-----XM---M-M--MBE-------B-?oM--B----oo-BX------------B-----E?M-----o-|-M---E---EB-BE---BE-M-E---E-M----X-X|
|----B-oE-?-----M------M--o-o?-B--M---B??oB---BBE---MXo--B-EE-o--o------X----E----M--M------X----------E----BE----M--M-BB-M--X----------M-E?-----?-M------------oB|-BB-E--E-E-M--o-M------BB----T-X--MMv
--E--B--?X--XoXE----MB--ME--B-o----BE?--oM-?-----o-E--EM------o------?--MX---?-oM---?M?-M----M?Bo---E-------o----?--M-o--EoXX-----?MM-oE-X----MXMo--------M---oX--|----B-M?-ET-E---Eoo-?X-E-XX--X--X---|
|--B--o-----?---------o--B---?E?---E-?------MEE---B-M--?-BXoE----?---?--E---??o---o-o---o-----Bo---EE-E--MX--?B----B-M----B-BoEMBM-B---oEE-B---------B?--E-B---E-TX?M---E-M--|-o?X--------M?---X-Bo-X--|
|--o-------?EM-oM--E---M---?E-o----M-o----B?-M----E--o----B-?-B--M--B-XM?X-B----oB----X?--oM-EoMEE-E-?-Eo-B---M--E---M?MMMM-BE---B---M-?-----o-XTB-X-E-X?----o---|-----EE----|XM--------X?---BEE---oEM-|
E--?--oMT-oME--B-B------B----o-----M----Eo-------?--MM-X-B-----BX----B-----o---------?-?---B-----M--X-M----M-------E--?B-?---?o--?X-B---BE?--E--XT--?-B--MTXT--XXXB---BE-o?--X-------MEM-E-?---o-Bo--TT?
o-?--B--|--B-?ET--M----?---E------EB-XB--------E-----?B-?BB------o-------o-ME--EX--?-E?-?---X---o-M--X---B-----M-B---M---M---ToM-------T------T--|-----?--|E|o----M---------oT--M-E--M----?E--?---MM?||X
B--M--?-|----M-|E-B-----M-M-----o--MTEoo---M-BE--------E-BB------?B---?-?--??--BE--M--?-?M-B-E-----B-M-------B---T---------o-|-??------|------|--|--MBMM--|-|--M-------T-----|-----------o--M--------||o
m-------|------|-----T--------------|---T-------------T-T-----------------------T----------T---------------------|-----------|---------|------|--|--------|-|----------|--T--|T----------------------|||
XXXXXXXXXXXXXXXXXXXXXXXXXXXXXXXXXXXXXXXXXXXXXXXXXXXXXXXXXXXXXXXXXXXXXXXXXXXXXXXXXXXXXXXXXXXXXXXXXXXXXXXXXXXXXXXXXXXXXXXXXXXXXXXXXXXXXXXXXXXXXXXXXXXXXXXXXXXXXXXXXXXXXXXXXXXXXXXXXXXXXXXXXXXXXXXXXXXXXXXX
