--X----o------------M----X-----------X-----------B-------X----------------------------------------------E---------------------------o-----------------X-------------------------X-------------------X---
------?--E---------------------M---------M--------BX--------------------------------------X------------------------------------------------?-----------E---B----------------------?------BE----------X--
-----------M------------------------------------------------E-EE------------------------XB-----------------------------------------------------------E--M-M--------------------?------------------------
--------------------------------------------------------o-o-------------?-----------------------------M?------B-------E---------------------------------------------------------------------------------
----------------------------------------------------------------------------------------------------B------------------------X--------E---------------------?---------------X-E--?---------X----B----X--
-------M----X--------------------------------------------------------------------X--------------o---------------------o---o-----------M-----------------------?------------X----------B-----------------
------B----------------------X----------------------M-------------------------------X----o---------------XE-----------X-----------------?---------------------------------------------------------------
-------------M-----------------B---------------B-----E--------------B----------------o------------E---------------------------------X-----------------------------------------M------------------------v
----------------------------------------------------------------------B------------?------------X----------------------------?---------------------B---------------------EX----------------------------f
-----------o-E------------------E---M-----------X-------------------------------------------E---------------E-------X------------------------------------------MX-----------------------X--------------f
--X-------------B-------------------------------B----------------------B-------------------------------------------E-------------------?E------------BX------------------------------------------------f
---------------------------X--------------------------------------------X--------XX---------------E----X-------ET--------o------------T------T---------B---------T-------------------------------M--oB-f
-----------------T--------X---------E-----X-----------------X---------------------------------------------------|-----?---------------|T-----|---B---------------|-X-----------------------------------f
-----------------|?-----------------------------------------------------------------------------------E---------|---------------------||-----|-?-----------------|-------------------T-----------------f
m--T-------------|----T-------------------T---T--T----T-----T---TT-T------T----------T------------T----T------T-|------------TTT------||-----|------T------------|------------TT-----|T--T--T----------f
XXXXXXXXXXXXXXXXXXXXXXXXXXXXXXXXXXXXXXXXXXXXXXXXXXXXXXXXXXXXXXXXXXXXXXXXXXXXXXXXXXXXXXXXXXXXXXXXXXXXXXXXXXXXXXXXXXXXXXXXXXXXXXXXXXXXXXXXXXXXXXXXXXXXXXXXXXXXXXXXXXXXXXXXXXXXXXXXXXXXXXXXXXXXXXXXXXXXXXXX
