---?M-o--E-E---M--E-o?EM---XX-o?-B--?-Bo-?BBB--o--B--MME??oo?X--?E-XB-EM?XEBMBBBo?EX-EM?-?M----o-BBM-XXBE???Eo?--X---MB-M-MX--MM-Mo--E--o--?XBBBMBo-E?-oB-XM?----o-MXoX-oBM---MEXoXM--Eooo-??-X-o-MEEXM-
-BX??--oEMEBBM--EX---E--BBEE----Eo---o-?-MBMBo-??M-?-?BEMMooo-o-X-?-BMo-X--EX-B-X--?B-XoX--E-XBX-BoEB--E--E--M-M-MME?E-B---E--?M?-?E--??X?M-M-X--?Xo?EXX-X?-oEBEM--?o-B?Mo?BB-Eo-o-?XooBXo?BEEX-E-?-E-o-
--E---EMo-oB----?M-o---oM--?EEX--BXEEM-?XEM?--Xo?XM-oBEXo---EB-M-M-M?Bo--o-E-Eoo-BM-EB----M-??X--XBMX-X--EE-MEB-M-MXBo-?BM----BE-o--MBoE--XoB??--o-Mo--EEEXEE?-XM--EEB?X?--X??-B----?E-?X-M-B--o-B?-MEB-
--B-oBXo--MoB-?E----EXo?EBBME-MMBEBo-?ME-MBM-B-E-X-BB-o-M--BM?E----o--B?X?o--BEX---M-?-?-o-MoE-X-oM-X--E----Xo-Eo-M---E??B---B?MEX-M---ooBX---MooB?EMXXM----?-EBoBo--MEo--oMoB---M-M-M---o-BBM-XEEMXM---
-?--?--?BEB--oo-E-B--o?EMBo-?--MMMB?X--BB-M--X?-?X--B-MBB--o--EE?M-?--X-oX?oo-oEXBBM-------oBXo--XX----oE?o---E?MX----B--M--B?X--ME-BM-?EBMo-ooX?E?B--o--oEB----o?M?EMM-MB-oXE--XE-Eo-EB-E--M--M-oMEXX--
-M?-o--X---E-M-M--M---?oXXEEoEE-X-Bo--E-oME--BMEM?B?---B?-?---M?---Mo-E--B-BM---BM--B-Mo-BE?--?EMMo--MB-----Boo?-B-?oBo--M?B--o??-EB--oo?X---BM-XE?-E-?-M--?---EE----BooB---MEo-?-o-X----E-o-oEM---BEE--
-B-?MB?--E-MXEX---EM-MX---oX--XB---EEB-X-BoBE?--?-X----X-o-BE--o-?--oB-EM-MM?XX--MMBE--Bo-B---?E----MMMBX-M-E-XMEEoBoEE-M-?Eo-BXX-XoMX-XXMB-o??X??-E-o-BoMMEoEXE--?M-MoB--BX-EMo--?------?---XMB?-o-EoE-
--X-MEEBX-X?o?Mo?M-Eo??E-M-B-o---MoM?????X-X-oEB-M---MXB-XM?-E----?---EB-MM-o-E--E-EM?o-?XM--EEEE--X?-BXMoo-o-BEXXEo-MM--E-oB--B---oB--XXE-XEB-X-oM-B-B--M-XMX--EBoM?E-o?-B-BoEMMB---?X--B?o-B-o?-Mo?X?v
--XBBEEMX-B?--BMBBXX?B-BX-EX?-MX?--o--MEBX--?-XM?-?---B--BM??-o--??-o-?M-X-?-EBX-?-?o---E--?-?-?E-X--?MX-E?--Xo-XMB-MoooMXMXBX-oo?EXX?M---E-M-B---E?-B--oX---B-M---o?X-o-?oB---E-MBMX?-EXBBEB-oB?BE-M--f
---X-----X-oX-?-BM-M------?MX-EBME-XMBo-EBM?----X?XMMB--?-o-??-ME-XX--M-B?MEEoBXB---Bo-B---X----?-o?--MoX-MMoM?oXo----M?M-MMB-BXXo-?XM--oooBo---o-E--oE--E-oo-B-oB-X?M-oBEMo-B-BE?BoEX-XXXB-E--B--M-BB-f
--M?Bo?----o--B-MXo-B---M-?B--B-XMM?-X-Eo-o-o-oo--oXM-?M-X------E---EBB-o-----o?--B-E-EE-oMX??X?---o?-X?E-EBX-XXMEME-X-X-XoM-B-oEX-?oBo-M-X-?-??o--------?XBo?-o-X?BXE-oE--M-X---E-?-??MXMEX-X-B?XE---Bf
-Eo--?-MM-E-?Bo-EBoBXM-X?BM-?X-MMB---XXMEMBM?-M?E-X-M-M--oXo-XM--EE--?-??B-B-o-o-X?o?-EMoooBEX-M--EXM-?M--o--?--BM?-BoBX--XM-EMo-M?-----oMX-oM-E--o----EBBMo---?EoBEo?M-MX-X-EBX--B-XXB-EoEB-B--X-?B---f
-XBM?-MoM--?B---XE-MX--BE--B-o?-E-Eo-XEoX-??-oEE-BEBoEXBX-oooBM?-ME-BoX--oBMM-E-XB--ME-?oBMBMXE?X-??--??MB-?X-EX---M-o--?EXoX?B--XB-oX-o-MEBEB-o-X-?BEE?MME-XXXXM?-MM--oo?M-EE--EX?-?B?ooBM--B----MBooMf
---Xo-X--X?--oEM-BEEXE?B-?EBBo?o-?M---B?-?B-EEE--Eo--EEX--o?B-X?XX?o-MB--M--oE?-B--o?EBBM-?E-EBEB-B-XX-ooM--BooB---o-BMX?----o--oX?M?B-MMMo---?MoE-B--BE--?-oXEE??EE?-EX-----XooB-XX--X-XBMM-M?B-?X?oXMf
m--EE--EX--X-X--Eoo--o?XM-MM-MEEE-?E--XE-MMEoX-?-B?EM--EMM--M?EBXBEB-X???-EMB-?oX?M-B-?-BME?-----?X-?-?B---M-oE-M--?-MX-MoE----X---EM-?-??---Xo?o--X--ME-o--E-B---Mo---X?--o-o?MoM--XoE---XXMEB--?M?M?-X
XXXXXXXXXXXXXXXXXXXXXXXXXXXXXXXXXXXXXXXXXXXXXXXXXXXXXXXXXXXXXXXXXXXXXXXXXXXXXXXXXXXXXXXXXXXXXXXXXXXXXXXXXXXXXXXXXXXXXXXXXXXXXXXXXXXXXXXXXXXXXXXXXXXXXXXXXXXXXXXXXXXXXXXXXXXXXXXXXXXXXXXXXXXXXXXXXXXXXXXX
