MBo-E-EM-EoE-EX---B-oB----MB-X-oXBM-E?XMo-o-Mo---EM-EMXo-?-??-?-EMMoB-M-oEX-B-E---o--XBMXBo-Xo--M-MB-M-X---E--oEB--o?----BoXEB---EM-B-?-EEMoB-?BM-----?--E--XEX?-o-?EM-M--M?ooE--o--?o--Mo---EoBB-o-M?XT
BB---BB-o-?BX?----MMM--B-EMooEMB---MX-B-X-M-X-o----EXE--B--EBE-E--B-?BME--M----X?X---M------Xo-?EEo--?-B---E-Eo---E-oE-BXo--Eo-MXE-BMBE---XMEE----?--XBM-EB--o-o-X-B-o--Mo-MM-E?oo-BB--E?-X-oEMM---E--BM
MB-E-?XMoXEoEMooB?-MX--E?M-?X-oEBXo--B-EBMo---X-B-?-B-o---?o-o----EX-EMM---BTEM-EXE--Eo--MoB--E--E-B-X-E?Bo?EE?--MME?BEoB-EM-E--M-E-?-?--XM--Mo-----MMB-o--M-Mo-?EooBoEoM-EXo-E--Xo-E--oMX-?-B--MMM-Eo?o
o---?-------------XBM---EB--?oo-M-E--M-oB------X----?------?o?--EoE---?--o--|--EX------oB----B--E?--?-oE---?-BX-oM---?-E-B--M-M----X-E-B---EB?X-o---?--E--XE---BX--EX--?--?-?----oMBo----E-o-----X--B-o?
EBE----B--o--MM--o-----MBM-E--M-o---X-?--?--o-X----B?----------X-----oo--o-BX-------E---------?------oM---Eo--E-?---B---M--------o-E--oo--o--B--------T?---?-------oB--MB---E-----B--M----?--B-MXEX---??
|B------EB-----E---X---M--B---------o------E-o---M---X----BM?E--oB-E-M?---B-------M---X----M--MM-B--B---X------X----o-XX----?-B--o--?---o-?--E--E-E-??X?--E---BM--Mo--MM-B--?X-?-X-BE-----------oM?X---X
T?-X-EX-BMEo-o---B--E-oB--E-E-M---M--MB---?B-M-M-E-M---Bo------B----E-o-X?oB-B?o-M-E----BoX------M---?M--BMB-BX--B-BE--oMB-E-----?--------BB--M----EE---BM---?--o-o--B-------E?-------E-oo---EM-B-?M---E
E-o-------?B-ME-------EB--BB----------MBX--?---B-EBE-X-M----E--E--?-------E---BB---EE-EX--BM-M-XXB----------X------BMM--------?---E--E-X---M----M------B?--B----E---T-----X----B------E--o-?-Mo?--B-X--v
XBEB-------E--?E----M---XoEMoE-MM--B------E---M-E------?-XE----------M-X---------?-B-BE?--TEMBXo---------B-BBo-XX-B--BXB-----E--MT?---TB-M?M-----oXB-X--E-oB------E-|----M-----oB---E?EM-------B-------X
BME---M---M-Mo---M-EM-o--?E----ME---M---BBM--X--oE-EX-M-----X-o---------E--B-o----o-o-B?--|-E-?----o--B---------E-oE---M-----o-XB|---M|-o----o--X-----M-E-B-oMMo-E--|--EE-BX-----X--o?--EE---ME-E--oEMEB
?---B-----M-o?-----EM--BM-M-MM----X--o-X-B--?--MoE-?--------E--E----o--o---M-BXooB---BE--MXoE--ME-B--?---MB---B--X-E-o-M-M-B---?-X----X-----o----o------B------EE?--XBMBB?-MMBo-B---E-----o-E?-M-EX---EM
M-B--?Bo-------BX-X---B-ME--o-B--o----------M--?---EB--X?BooB-???o-----E??--oEB----X--?--------o--MT-o---BB--E-M-?MM--?-M?---E--X?BX-M-BXo-?-----o--E---MEEo----E-M-M------B--?---o-------M-M--?--MXo--T
--M-?o----M??M-E--o-----M---o-EM---BXB--BX-?-??--E-E--?-o--o-B-o--------EE--M-B----o--B-M---T----?-|------?--o--o--TE----------E--?---T-----?-----BE-M--?-?oo-ME----o---Eo---M---o---------X--Xo---MB--T
E---------o-oo?------B--------------B---TBo-o---ME---oM--M--?-XMEo-----T---------?--M-------|-B----|----MB---o---E-|----B-T---BTo-??o-|-BE-BMo-?--oo-B--M-BM-----X--E-o---TT-?---oE-B--?B--E------T-M--?
m------------------------TT-------------|------------------------------|--------------------|-T----|----T------T---|------|----|------|-----T-----------------------T-----||---------T---T--------|----X
XXXXXXXXXXXXXXXXXXXXXXXXXXXXXXXXXXXXXXXXXXXXXXXXXXXXXXXXXXXXXXXXXXXXXXXXXXXXXXXXXXXXXXXXXXXXXXXXXXXXXXXXXXXXXXXXXXXXXXXXXXXXXXXXXXXXXXXXXXXXXXXXXXXXXXXXXXXXXXXXXXXXXXXXXXXXXXXXXXXXXXXXXXXXXXXXXXXXXXXX
