??-X-EX-E?EBo--XE---M--EXoXo--X---BX-?B-MBM-X-B-MME----?-MX-XXoo--BM??o-M---MBB-MXMEBX--BM--oMo----o?Bo-XoM---BBM---X-----M-o-oM?EMMB---o-MM--o?E?X-B--TooM-XE--o-MXo----M?--X?-MX-EBB?T--E--?MMBXE-ooXX
M----o?-M-B-EE-BE?-ooE?BE-E-BBM-M-?-EoXXo---EXBX--o-Xooo-o-E-?M-E?-X-BX---?X----X---?-BM-oo--?o-E-BEB-XoBM-?--oE-----Bo-M----E---o-o--XX-B---B-X---E?-?|-B-EBXBEo?--o?E-B-E-M-EBoE-XBXE|?XEXM--o-ME--XBM
o--X?--?o-E-B-E?X-T-X-------oEMXo?o-?EE-?M?-o-E--o?-oBoo---B-MXB?-EE-oBo-MM-X-XB-M-B?EXEMo?-EXE-MXo-XMX?Eo-M-B-o?E-ME-EM?Eo-?M-----B-BXXMMBMoEoE----XMM|EBM--BEM-BXXTXXXB-?-E---XXE---?|-------oM-XM--BE
TMX--o-?----X-?---|B----?-MX-E---EE--M?-o-----oBX-----E-----o-E-X------------------BM---o------?oX--MX-o-B-X---?X--E-XE-Xo------B--B---------B---------|----E-------|M-E?X-oB---X-?-M--|-------B?---o-XB
B-E-M?o------o----XB--BMB-??oBoXoE---?----?M-Xo--?-M-T--X---o---?---E---E-M-E?----MEBM----?o----------X------ME-------M-----o--?MX-------ET??-E--E----MXX-E-B---M-M-XBo----B-X------E?BX----X-----XB-EMo
?---ETB--?-oB--ME-EM--oB?---B----?M-------E---M-?----X--------??---XE----o---B--XM--E---E--B-E-o--?--M?-TB----M-----MM--E-?M--M-M----?----XE-B--ME----------oM-X--?--------------------B-oXX?EX--------M
ToE--|-E?o--E-?-?----??-----?-E?---X-----?-EBMo--B?B--oB-X?-M-EMX----Mo-X-------?---o-B-----?---E-?X--M-XMX-MM----M-------E-XX---X-----M-X-E-?--MB----B---------o---------X--X-------X-------?-----XBX--
EB-B-XE-BE--B-M----oTo--B---o---oB---X-oM--------B---M-o-E?---B-MBM-------X--E------EXME-oE--M----B-?B-?---?M-BE--------M-----B-T------BEM--X-E-----X-o-X--E--M----o---------B---XB---------?----Eo---Ev
M-oE-o--?oM------B--X-MB----?--E-M?E---oo--M--------E??-EE-Eo-T---?M-XXB--M--?-BX-----B---BE------o---o-E--o--E---B--o---?o-----XBX-oMX--------MEE--M----M---?Bo----?-X-----M-----o-X---o--?M-BEEE-ETX--
--M-----M---B?----B-----XX---B--X-E----o----TMoB-?T-----------|---B------E------B----EM-------oM-?o?o-o--EB----M-?-?---XM-EXX---M-B---M--oM-E--M---?-----?B--EM--------X-----B----?-M--X--------o---|o-?
E---------?-B--X----E-M?B---?o---X--M---?-X?|-----X-oE---???-?X-T-----M----B--MB-o?E?-?--M--B-B-X-M---oB-M-?--M-E--?-Mo--B?-o-oE-?-M--------B---X---E-Bo?------?------E------BX---oX-X-M--MXM-----?-X-XE
o-o-X---E--------o----?--------o----To------|o-X-------B-------TX---E-----?-M--T---B---T-------?----o-----EE--------T-E-o---o-------BTX---o-M-o-T-----B------X-----X---o-?-------M-T------------T?--ET-M
ETT---MToB----------X--EE--------o--|----B--X------B-B-TM------|------o-B---?--|----M--|-oX-------------X-?-----o---|---------E-----B|-o--BE----|--T-B--?E--M-----M---o-----TE----?|-T-X------T-|-M--|-?
-||----|-----M----------------T-----|------M------?--B-|----X--|----X---E---T--|-------|----T--------B---E--M-------|-----------TE---|----T----T|--|-M--B-----------------T-|------|-|--o---T-|-|----|-|
m||----|-------T-T-----------T|T----|----T-------------|-------|------------|TT|--T----|---T|------T--T-----T--T----|T---T------|----|----|----||--|-T----T-------T-------|-|------|-|T-----|-|-|---T|-o
XXXXXXXXXXXXXXXXXXXXXXXXXXXXXXXXXXXXXXXXXXXXXXXXXXXXXXXXXXXXXXXXXXXXXXXXXXXXXXXXXXXXXXXXXXXXXXXXXXXXXXXXXXXXXXXXXXXXXXXXXXXXXXXXXXXXXXXXXXXXXXXXXXXXXXXXXXXXXXXXXXXXXXXXXXXXXXXXXXXXXXXXXXXXXXXXXXXXXXXX
