------o-----------M------------------------?------?------------------M-X-----------------------------------------------------------o--------------------------B-----o-----------------------------------
-?------------------------------------------------E-----------------------------------------------?----------------------------------M---------------------------------?--B--------------------?--------
-------------------------------------------------------------------------------------------------?-------------M-------------------------------X--------------------------------------------------MX-X--
--------M-----M-----------------------------------------------------------------------------------------------------------X------------?----------------------------------------------------------B-X---
------------------------------------------------------------------------------------B--------------------------------------------------------------------------------------------?-?--B-----------------
-----------------?--E------------------------------?-------------------------------------------------------------------------------------------------------------------------------------E--------------
------------------M-------------B-----------------------E---------------------------------X------------X-------------------------------------E?---------------------------------------------------------
--------------------------E---------------------------------------------------------E-----------------------B---------XB-------------o-------------------------------------T------------M----M---------v
--------B--------------X--------------------------------------------------------------------------------------------E---------E---X------------X---------------------------X-------------------------X-f
--B----------E----------B---------------------?-----------------------------------X-------------------------------B-E-------------------------------------------------------------------B--------E-----f
------B---------------------o---------------------------------------------oE-----o----------------------T-------------------------------E------o-------------------------------------------T-----------f
--------?-----------------------------------------------------------------------?---------o-------------|-----o-----------------------------------------------------------------B----------|-----------f
-------E----------E---E-------B-------------------------------------------B-----------------------------|-------------------------?----------------X--------E------------------------------|-----------f
---------------------------------------------------o-------------------o--------------------------------|----------------------------E----------------------------M------------------------|-----------f
m----------EX-----M-o---------XX---X-XX-----X-X------B----------?-----------------------------X------o-BX--X--------------------------o-X--X---------------o------M--X------X--X--X--------X-----------f
XXXXXXXXXXXXXXXXXXXXXXXXXXXXXXXXXXXXXXXXXXXXXXXXXXXXXXXXXXXXXXXXXXXXXXXXXXXXXXXXXXXXXXXXXXXXXXXXXXXXXXXXXXXXXXXXXXXXXXXXXXXXXXXXXXXXXXXXXXXXXXXXXXXXXXXXXXXXXXXXXXXXXXXXXXXXXXXXXXXXXXXXXXXXXXXXXXXXXXXX
