MBooE?--BE---oMB--BB--EBM?X-XEE--E-BXMo?M--XB--BME-o-EEXMEEBo--E-XXE-B-?M---Bo-ooM-MX-E?---o---XoMoB-?MB---XoE?B?-o--B-Xo-----M?E--BEEB?-oo-XBB--Bo??-E-BMB?--E-XMM---oE---ME-o-----oE-MEM??MB---BMM?-BT
-oXM-?MB-MXM-------o---XB--E---EM----Bo-oBB?-X----MM-B-B?BM?M-B-M-B-M-o-M--oE-oE--B--E---BB-oX--EMXX-B-B?X?E-M--?B-M-B-XXM-o-?-B--?E-MB-XEX-EX-o?-?BM-MBE--o?---BEoE-oBX??BXo--B---XoX--XE--XE??M??-Booo
EBoBM---EEB-B-EBMB-X?-X--MBBBX-M-?--Xo----B-BB-M-E--E--Bo-o-X--M-X--?-oMXE--?----Bo---?o--?-?o---MB--B-oM?o-E-oXEB-MB-o--E-EE-??BM-oo-XE-MXEB-?--XXoEM-EE---?-o?EM-?E?o-Mo?BB-B-o-E--BB--BEX-BM?-E-MXB?-
X--?---o-X?-oX-M-?B?-B?---EoM---EX?oB??Bo--M-oBooXX--E--B?-XM---o--BMX-?M-?EM---?--XBM-B-oB--?--o---?---XE-MBM--BM?-o--EEBo--E?o---MoEX?BMMo--MoBB?Mo-MX-BEBM-BEX-M--EE--XE-B?BM?oXBBMMB-XXM---?MM-E-?MM
BE?-MBM----?---X---X---?o-Eo-oEEXXM-BEXBB-EX-?M-Eo-M?B----X--???E-MM---B?-o---BBM?E-MB--?M?oBBo?--?E-?MMBo---o--E?EoB----Moo-------X--?o---oX-?oM-??XBB--BX-EX-BEMEB-BB--X---M?B--?-o-B?-EXo--EBE?Eo-B-|
T-E-BBoM?--X-----X--?EEM-XX?o-?--X----o---E-oBMM?X-oMXB-oX-XBM??BEM-E?E---?B------M?--M---ooBM-MBM?X--o-BoXM?--M-BBoME-M-MXE-o?-?----?EoEEBoEBBo-MXEoX--oM--E??XEXM--?---EE?MooM?o-ME?M-BME-B?oM-BEBBMoB
M-?-oE-E?---?oMBXE--BMM--??o--E-oEBoXXE-?--MB--o-XE-EE-B?B-X-B?M--?M--M-M--X-?--?Moo-M-M-ME-M??---X---o--B-----E-Mo-XMXM-B-MoBBEB-o--MEXX-o-----?M--B?M-BM-oXB--B--BBE-MEoE--XMBXB-X-o?--BMM?Mo-?--X-E-T
|M-X-E--EB-Mo-B-M---XB??-MM---BXBX-XEMo-?E?B--oX?E-BXE-Eo-EBE----M-oo-B-o-B-B--oXo--EM-----?--EBBEE-EXXB--MME-X?-?--M-M?o-?BXM--?M-X--M-E-?MXXB-BM--?---?EM--?--E-o-X-XX?-o---B-o--X-X-?-M-?EoM--M-o-oov
X-----EMX-M-oEMXMB-B-M-M-M?-MBMX?oBB--?M---B--MMBMEo-E-?oB-o?-BoM?o-M?B--oEM?-M----?B?--?-o---EMMMB?---MEE--MXo--oM-XX-XB-o?EB?E-?-BM-BBBoEoBX-ME?X--B?--o-BX-XBEo-M-?-oo-B--MX----?BBoMXX?ME--?-X-?B?-B
EMBXM-o--XM---?-BXXE-X-E--BB?-MoMBE-?-oo?-M-??B--o-M-XX?--?MXE?---oB---EM?-EE-BEEBX---EMXXB--X-EoE-?------X?--X-X?--o?----BX-E--M?--XoX----XE---M?--oM-X-Xo-X--XMX-BMB-?ME---XoEMMMooEX?oMB-X---E-XMM-XE
oE---EEoB----E---?M--?-X--oE-M-EMM--o--ME--XEB-EE?-MXXMEMBBX?--EE-XE---BXE-MX---X?XB--B-?E?X?--XM?Xo-B-M----M--M-E?X-M--MEB--B-X-o--oE-o-B---MoX--B---oXE---oX??---EoMXE--Mo-?BM-BX-MMBE---BEB-oME?--MEB
MX?XEB-o----B-BX-BBB?MEX-M--E-?B--M----EEE-?E-BMEEX?-MM-B--?B--BB-B--B?X----oBX?X?XX?--o?MEMX-E---E??-B??EB?M?MX-o-M?XB-E-EE---B-B-?-?-XM--BE---MM----E--o?E?EM-MoME-oBM------X--BEoXMB--MBB---EMoMEoB?|
o-o--?oMM-?E-B-?oE-oB--EBoXo?o-X--o-?o--EXX---XB-XoXo-X?M?B-EXBo---BoB?XoE-EEMXX--o-?-B-Mo-----?-B-M-?M?--?-XB?M-M--MB-?B-----E--E-B-?-XXM?-BEoEEo--B?B-B-?-MM?MEB----?X-?M-B---BoXooBX-Eo-BM-EB-X--oXB|
B-?-M-BB-MB----X-B-----EX--o-XMo-M--?-EB-X-MBX----E--MXX--M?-BE?MX---MB-?o-M?--?B--X--E-M-?-XMMMMMBB-BB-M---BX--?-MBoB----E-E-E-E-oE-E-?X-?o?o?-o-B-EBEXo-E-XX-o-?B-oE-MEo-B-BX-XBX?E-?B-M-ME?X-BE--MXET
m-?X-XXo?E-B-EB---X----M-oBXBB--MX-MB?--oBXEE------M??B-B--MX-M-Bo?o--BM-B---oMEo-?M-o?oEMB--oMB??ooXMMB---???E?----B--Xo-XBEoX-----BEB-?--EMM-----E?-B-E?--?--o-----E---o----MMXM-?--BM-M---MM-X-E-B-M-
XXXXXXXXXXXXXXXXXXXXXXXXXXXXXXXXXXXXXXXXXXXXXXXXXXXXXXXXXXXXXXXXXXXXXXXXXXXXXXXXXXXXXXXXXXXXXXXXXXXXXXXXXXXXXXXXXXXXXXXXXXXXXXXXXXXXXXXXXXXXXXXXXXXXXXXXXXXXXXXXXXXXXXXXXXXXXXXXXXXXXXXXXXXXXXXXXXXXXXXX
