---------E------------------------------E---------------------------------------------------------------------------------------B-----------------o-----M--------------------o--o-----------------------
----?---------------------------X---X---------------------------------E------E------------------------------X-----------o-------X-------------------------?---------XX----------------?-----?------X----
------------------------------------------------------------------EM------------------o---M--------M------------------?--------BM------------------------E---------E------------E-----------------------
-----------------------------------?---------X----------X----------?------------------------------------------------------E-----------------------E-----------------------------------------X--?--------
---------------------------------------------------------------?--------------------------------B--B---------------------------------XX-------------E---------------M-----------------------------------
-M---------------------------------------------------------------o---BX--M------------------?--?-------------------o--------------------------------------------------------------------o---------------
-------------------------M----------------------------------------------------------------------------------?-----------------------------------B-------------------------------------------------------
---------------------------------------------------------B-----------------?----M---------------E--------------------X-------------------B-------------------------------------------------------------v
---------------------------E---------------------------------o---X----------------E-----------------------M-----------o------------------------------E------------------o------------------------------f
----------------------------------------X--------------------------------------------B-----------------?-----------E---------------------------------------------------------------------B---------X---f
-----------------------------------------B---------------------------------------------------------------------------------------------B--E-----------------------------------------B------------------f
-------E--------------------------?------------------?------------------------------------E--------------X-----o-----------?---B---------------------------------------o-------------T-----------------f
---------M-----------------B--------------------------B---------X----B------------------------------------------------E-------------------------------------------?------------------|---T-E-----------f
------------X---------------------M----------------------------M-E----------------------------------T------T---?------------------------------B--------------------------------------|---|-------T-----f
m-----X-----XX-----E-----XX----------X--------------X----X--------X--M-X---------------M--------X---X------XB-------E----------X---------------X--X--X-----------XM----------X------XX---X-------X-----f
XXXXXXXXXXXXXXXXXXXXXXXXXXXXXXXXXXXXXXXXXXXXXXXXXXXXXXXXXXXXXXXXXXXXXXXXXXXXXXXXXXXXXXXXXXXXXXXXXXXXXXXXXXXXXXXXXXXXXXXXXXXXXXXXXXXXXXXXXXXXXXXXXXXXXXXXXXXXXXXXXXXXXXXXXXXXXXXXXXXXXXXXXXXXXXXXXXXXXXXX
