---E---oE-ME--EMX-o-B-oEXM--XXX-?MBMBBo?o-EBM-B-EMBMo---?-?-M??B-B?Mo---B--BBBM-B?XB?o--o?----E-Mo---E-?-B-ME--EM?Mo-EM-B-E-XM?-XEM?-X-oEB-B--B-MXB-BEXXXE--X--?EEMXB?X?----X-XE--oo-BBMoB-??X----?-ooE-
--E---BBBoBEEMEB-o--X-----B-?-MMo--oBXo--?-M--Bo-E---E?--EB--Mo?MBMX--?E-o-MM---MoEMEEE-B-M-oM--?----XoE---oo-B-B-M--o?EME-o?-----??EE?XooXM--B-?E--???o-E?M---BX--?-XBEo---ooEXo-o----E--ooXEo-XM-E----
--MEE?-X?-oB--BE-o------E-M--E-XM-E-oo-?----M-?XX---B---BM-B-XX--oEB-MMB??o-?X?-B-oM--?-o-X-E?-??o-E-?E?M--?BE--o-X--XBBo-----X-M----?-----?---o---oB---?X?oX--XooM--B-----EM-E--BMB--o--o--MEXEM-?Mo---
--o--X?M-X-BEB----MBX-----oE-MM-------T--?--BM--------o----o-?----------o-o?--BM--B----T--M-M--M---EB---ooEooo--XB-XE---X-----o-M--B-M------E--o-X-----Eo----E-B---o-B---o-X-----E--BBX-?-----?----E-?--
-------MMME-o--X--B-----E-o-M?---E---BX-E---B-M?-----o-BX?-E---M-B-B----B--M--M-Mo-M--XX-----B--B-X-M--E-ME----M?-B---B----o-X-M-------M-o-----BM-o----?o?-E-o-B-o-------o?------?B----------Xo------o--
-BX------?--BX--B-B-?----?----------B-E---E---BM----M-----E-?--B--E-E-XoE-ME---ME----??E?X--------B?---E-B--M------E-E----M--o?TX---X?-----B---?-?--E-o---X---M--o-o---?---?-BEoM--oXoX?o---BB--B-o---?-
-E--B----E-M----?oB------Mooo------?o--?-ooB-o--B---M--B--M--M--M-E-M-------------X--Eo---?--o-Xo---Eo-o?B-----BBM--?M--o--?---Xo---E-----?----B-Mo---------B--XX---------X-E---MEX--B---E---?M-o-M--XE-
----o-o--o-?--E?---?----X-----------?--EX---?M-B-BM---ME-----B-oBMM-Mo---?o-------oB--MM----X-X-?o----BMo-E------Eo?-MX--?----oEB-MM-E?M---oB-E-X--?----?--MB?E---EoX-?B---?--XMo----M?B-MX?--B----X-E-v
--B--??-B--B--B-BX---Bo-B?E-T-X--o---?o?--EE---oE---B--B?----o-----XB---B--X?---MM--B-------MX?-o---o------B-o----B-X--M-BE--?M--X-?------Mo-M---XM-XM--B-----B-M-?----------o------XE-o--B-XEM?------Bf
----X--X?--o----B--?o-------|M------MMEB------B----oM--M---E----MM-BM--?E------?--oM--------o--BEX-BE-X-------M--oBX?BE--MB-------o--EM--B---E---BB-ME------E-MX---B--?-X--BMM-XB--?E-?---?BE-M-XoM-X--f
--B-MM---o-oEE------o-EB---?X-o----M-E------X--XE--?EE---XME----B--B-------?-M----E--M-B-?EM--B--??--B---------B--BE--?M-----------TME--o---M--B--------X--o----M---o?--o-o-o----MT--M---EoE---X-------f
--?---XX-E-E-B-XE-----------?o-------MXB-X--MoB-----B----o----?ME----MME?E---oX--?--?B-E-o---?---E---M-M?B----?-X------o------B-B-BXBMo---M-EE-----M--BM-BE----XE--oo-E-Mo-?-EE--BXB--------B---------Xf
-E--o-------------oM---MoM?---?----BBo---E-TB------??-----?-----M-X----MB---oE-----Bo--BM-------o-B---M----------T--E--M-o--X--XE----EM---B---?------M-M--?o--E-To-E-------MX--o----B---X-?--B--EEBT-XBf
-B----M------M--T---MB----?----------------|-o?------o-o-?---------M-o---XoM------M-E--B-BM-----?X-----B-----o---|----------?BXT-------------BMBM--o---T---M----|----EBM--oE-?------B--BE--T-T-M--M|-Mof
m---------------|--------T-----------------|---------------------------------------T--------------T--------------|T---T--------|------------T----------|--------|-T------------------------|-|-----|---X
XXXXXXXXXXXXXXXXXXXXXXXXXXXXXXXXXXXXXXXXXXXXXXXXXXXXXXXXXXXXXXXXXXXXXXXXXXXXXXXXXXXXXXXXXXXXXXXXXXXXXXXXXXXXXXXXXXXXXXXXXXXXXXXXXXXXXXXXXXXXXXXXXXXXXXXXXXXXXXXXXXXXXXXXXXXXXXXXXXXXXXXXXXXXXXXXXXXXXXXX
