M?--B-EoEoE?BEB-?-E?EMMoB-X-E?-EM-M-?oXE---E--M-BEBX?XX--oBE-X?-M?B-Mo-EE-Mo-Eo-Xo-X---oE-BE-EoM-?XEX-X?XXEBXX?oXBM--?--?XEoMMo--MBX-BB--B?E-?BoM?B--?XM?-oE-BB-EEo--EEE-----EEoMB--Mo--E?------??-B-XEE
MoM--?M-M-?X-?--M-M--EEB--MEoMEM--?X-XEEBMB-----??M-B---E?---?EoM-XB-?---XB?X----MM-B--?-M-oX-BX-MX-?--ooM--MM-X-?BoM-o-B--?-oB-X--o-?M--B?-BX--?B--EoE?-X----Mo----B---M?oM-EMMo-BX---?oEEE--?-BX-EM-?|
|B-Eo--oBEB-XX-----oM---T?--------BB--M-EB-B--XBo---o-E---X-MX---B-oTBBMM--oME---?MXB?M-?-ooo----X?MME--o-Xo--o--ET-ME-oB-XB?X-B----BMB-o?-BB-----EEX-M---o------EoE?EMoE-E--oXMBMo--?BB---Xo-oE--M?-M-B
|--E----Eo-E--X-?---o?E-|----E?-M-E?--o-M---X-TE-?----X?-E-o-oB-BXMo|?T------B---M-----BE---M-MBo--X--o--M?EE----B|-M--------M---X-o-M-T--TBXB?--M------?--M-----B--E---EX--BEoX-?-BX--?--oMo-X---B--E-X
E----------MT-BB??T--B-oXX-M--M-B--BB-------?-|?o--------BX?B-MM--B-X-X--X--B----E--B------oB--ME----o---?--M-----|--XM---o-B--XM--B---|--|-T-------E--T?------------M-B-T--?-?---B----TT--o--o-BMBB---?
o-M--BM-B-B-|X----|-X-BooBEM--?-?--------E?---XBo--BBo-----B----?-M-?-----B--oM-B-B--?-o-----------E--M?-o-X---XM-X-X-------o--?-M---E-X-B|-|-M--------X---X---M?o-------|-M?o--XX-M-M-||M--B-ME-------T
BX------o-?E|-----|-M-E----M-EMo-Eo--o---EEM-----------T-----B--BB-o-TM-oB-?--TX----M-X---B----E-----E---EE---X-E--ooB---M-?--o--M-EX---TEX-X-oBBMM----MoX----X--T---?---|------EM-----|XM-Eo--o-o-M---E
B-----------Xo?--E|E--E--o?------MBB------?--E-E-EM---o|X--M--X--o---T-E-?---E|M?------E-M-X----B--oE----o----E-------XM------o----?----X--?oEB----XoX-E-----?-X-|-----?-|----XX-------|-MT------Mo---Ev
M----?-----Eo--X--X-M----?-o-?--o---T-------E--E---E---|-?M----X-?---X-M--TM-------To--B--?-?---------XM---X---M-BM---B-M-----?-o---------X-------Xo--X--ET-M----|--XM---X-E----MB?----XE-X----o?o-B---M
M-------------M-X-?--X-----B---B--X-X--BMB---------Eo-BX------o-?--E-----?X?--X--Eo|M-E-XM----o----X--o-E-E-TE---?--------X-------?--o-E-X------B-------BE|X---o-X-B----------B----EMoM------B-o----T-?B
M----EM-o----o-----B-oB----?B-------BX-B-?X--?-------E----MX?---------XBo-E--E-o-o-XE?--?----o-?---------E--XM----o---------E-----T---o-M-M-?-------oX---?|---M--o----E------o------E-----M---o-----|--o
|-o-T-B--T-----?T---M--?--o--MMo-o---E---B--X-T----oT---------EE-X-E-M------B---B--B--T---T-----------B------oT--XM--M---?Mo-BE---|o----MEM----------E----X?-T-------?EMoXB------X--T--M----T-----T-|?-o
M---|----|------|------E---B?--T---TM-?-------X---MM|-?-?ME-T---?--o-T--o--B-------E--|---TB-------X----------|------------?--o--EX--------------o-Mo--B-----|-B-------TT-----E--T-X|-------|-----|MX--X
E-EM|---X|-?-T--|--o-----X---T-X---|-B----?------TT-|-------|-T------|--E-------?---T-|---|---------------T---|-------T-?---B--------T--------------TT-----TT|----M----||------T-|--|--M----|---B-|T--T-
m-T-|TTT-|---|--|------------|-----|T------------||-|-------|T|------|---------TT---|T|---|---------------|-T-|-T-----|------T-------|T-----T--T----||---T-|||---T-----||---T--|-|--|-------|-----||--|?
XXXXXXXXXXXXXXXXXXXXXXXXXXXXXXXXXXXXXXXXXXXXXXXXXXXXXXXXXXXXXXXXXXXXXXXXXXXXXXXXXXXXXXXXXXXXXXXXXXXXXXXXXXXXXXXXXXXXXXXXXXXXXXXXXXXXXXXXXXXXXXXXXXXXXXXXXXXXXXXXXXXXXXXXXXXXXXXXXXXXXXXXXXXXXXXXXXXXXXXX
