-----------------M---------------o------------------------------------------------------------------B-----------------X---------o-T--------------------X------------------------------------------------
--M--M-----X---------------------------------------------B-----------------X----------------------M-------------------------X-----|-------------------X----------E--------------------------------------
----------E----X-----------------------------------------------------------M--------------------------------------M---------------|-------------------------------------o-----------------E-------------
------------X-----------------------------------------------X---------------------------------B-----------------------E-----------|------------------------------------?--------------------------------
-------------oE------X-------------o-?------------?------------------------------------M----oM----?-----------------------------oXX-------------------M-------------------------------------------------
---------------------------------------------------------------------------------------------------X------------------?----------------------------------------------------------B----------------------
---------------------------------X------------------------------B-------------------------------------------?-------------------------------------------X----------------------o------------------------
---------------------------------------------------------------X----------------------------------------------M-------E-----------?------------------------?-----------------------------M-------------v
-------------------------------------------------------------o-E----B-----------------oM---------------------------------M-------B------------B-------------E-----------------o----------------------X-f
------------------o-------------------------------M--------------------------------------------------M--------M----------------------E---------------------------------------------B-------------------f
--------------------?--------------B----------------------------------------------------------M-----------------X---------T----M--?-----------------------------------E-------------B---------------X--f
-------------------------------------------------------------------?----B-----------------------?-------------------------|-------B--------------------------------------------------------------------f
------------------------------------------------------------------------------M--B-----------------?------------------?---|------B---------------------------------------------------------------B-----f
-X--T---------------------------------T-----------------------------------------------------------------------------------|-------------------------------------------------------E-B------------------f
m---X---------X---o?---X---o----X---X-X--X-------X-------------X----X-B-------------X----------X-X----X-X-X--?--B--------XX---------------MX-----X----?-X------X---X---B---------X-X---X----X----------f
XXXXXXXXXXXXXXXXXXXXXXXXXXXXXXXXXXXXXXXXXXXXXXXXXXXXXXXXXXXXXXXXXXXXXXXXXXXXXXXXXXXXXXXXXXXXXXXXXXXXXXXXXXXXXXXXXXXXXXXXXXXXXXXXXXXXXXXXXXXXXXXXXXXXXXXXXXXXXXXXXXXXXXXXXXXXXXXXXXXXXXXXXXXXXXXXXXXXXXXX
