M?-Mo---o???E---B-X-oB---?oXo-?-?EEXXo-BoE-?-M-oB-----o?oMM-EEE--EB-oX--B-B-MoB?BEEE-M-?XX-EEX-E-BM-??oEMM-?B-o-EX-BE-B----oM?-?X?oM--M-o-oX--o??EEEBT-X-ME-X??Eo--M-----X?---X-oB?XEoE-M?---BE?X-X-o-XB
o-XX-o------E?--XM--oBXoo-B-?-BE-o-BBBB?--?-EB-oo--XB-EoB?o---o-EoE--o?--MX---o-----oB-M-E-?-oMM-B?--EBE?--?-E-o-Eo--oo-M-oE-BX-B-?--MXB-oE-M?-oB--oE|--?XM--??--oX-Xo--o-XE-oBEBXXM-o-B--EE?--E-EM-EM-T
BoE---EXEMooE-EBEM----B-oBX---BX-X?--E-?MMX-X--EXooB??-?-EMEEBXo-EB-BXX-TBMo----X-M--MEB----B??-M--B-o-?--BM------M--?--o-o--MMMo-?-T-M-BoXE-X-B-B-?X|M--o---EBE-B-----o?XBB--oT--ooM-M-EX--TMEB---MMo-?
---E?o-X-T--M--------------BE----X-oM---?----XX--------MB-o--E-o--??E-o-|E--------MM----X----o---B--oEoTM--M---E-?--B--MMX-M-------?|B----o--E-oE--B-|E---EX---B-o-M-?X?---?X-?|---B----?o--|--M----X--E
|o--M---?|?-----B-X----Eo-E-----X-X-o---MX-X-M---B----o-E-M--o-B--o--M--|----o-M------BX-B--X--X-MXE---XE-B---o-?--E-----EMM-ooo--?-|-B------MBo-----X----B--M---?----oM-B-----XX---o--E--X-X--?B?-BB-o|
B---?----X-oB-T--X---o----EE??MMB-------M?--------XBM--Mo----MXM----EM--X-o-----M---TEo----o-B-------MB------E---B---oX----M--------X--M--X---------oBo--oE----E---------T-o-----o----X--Bo--------M-?-X
oX--E-?--?--EX|-E----BE-?-----E-------MM--M--EX-X-M---BMM--MB-----------------?--o--|MBo---o----------B--E--o-X---X??B-----------M--MX-o-----?-EE---M--MM-M-E--M----X----X-EX--M-----B-MT---?X-----B---B
BM--o-------M-X---E?-B-M---B---XTXoT-o----BXoB-?-X--B--B-XB---T-?--M-M-EB?-B---X----|T--X-E?M--MB---o--??------BX------o?---oX-----M?--MMMBE--------o-?Eo---------X?--M---M--------?Xo--X?M-oE--B--E?-Mv
-E---MX?--X-o---o-------o-----X-|--|E--o--BM-Eo--B---MM-------X-?--o---M------M--X--|XM------B-----T-M--?X-X--B------EME?MB-?-----o---M-E-?--E-?---------T--M?---EM--EBEEX-M-------?----EM-----E---?-Bo|
E-?---M-------M----B-----?---M-E|-?X-B-----BX--XMo?---------M----E-B-B--MMX-E-M----MX---------X?B?-X---EoME---E-BoE-XBMB?-M--o--?--B---o---E--?----------|-X---X--E--E-M----BB---B--M-X---MX-----T-----|
E-B---------X-o--MoE-----B-XMoE-X---M-E---B--?-M-oo-ME-----X--E----M--o------M--o-------X-----ME---TE--?----M-E------o-o---oE--oME--XBM-o------o--------BX-BoXM---?-X--?M---M?E------?-B----M-X-?|-----|
-BT--T--oT--B--o------X------M----M-B--X----E-B------?B-TM-o-o--?E-------T---?--T-X-----T----------XE-M---To?-BM-TM-T-B--E------?-----------B-B-T---BB---B---E----?----Bo---B-BT---?-T--------?--X-o---|
M-|-M|---|-?--B-----?-B-B-------X------M---E--oB----ET?-|---------T------|----o-|-------|-E-E--oE----TTM-T|---T-B|-B|?----E----E--------T-M-TM--|---M-X-X-----T-o---BT-B-E----B|XT---|-------X-E-----T-?
--|-E|--T|---------B--MM---T---T----T----------------|--|---------|------|----T-|---X---|------T-----||--||---|--|--|---T-T-------------|-o-|---|-T-------T-M-|------|------TT-|-|-T-|--X------------|-|
mT|--|--||-------T---------|---|---T|------T---------|--|--T------|------|-T--|-|-------|T--TT-|---T-||--||---|--|-T|---|-|--------T-T--|---|---|-|--T-T--|---|------|-----T||-|T|-|-|---------T---T-|-o
XXXXXXXXXXXXXXXXXXXXXXXXXXXXXXXXXXXXXXXXXXXXXXXXXXXXXXXXXXXXXXXXXXXXXXXXXXXXXXXXXXXXXXXXXXXXXXXXXXXXXXXXXXXXXXXXXXXXXXXXXXXXXXXXXXXXXXXXXXXXXXXXXXXXXXXXXXXXXXXXXXXXXXXXXXXXXXXXXXXXXXXXXXXXXXXXXXXXXXXX
