T-M-X--o?-BX-?M----XMXXB--XM-o--E-?---XM--M-EX?B----M--o?Xo--E--ooBM?E?---MM---?-E----B---BM-MoE--B-B--M-M-Bo-XBBE-B-X--o-X?E--o-MXo-o-?MXBM-E-oBooM--oB----?E?-?M-XXM--ooo-MooB-----?-o-o--?M-B-XX-oMXT
TX-MX--E---BM--E-?-X?oB-B-B----B---EM---M----B-----o?-M-----X?B-B?--o-X---EB-o-M-X----Eo?-?E-?-XMo--E--o--E---?M---o-X--o-EMEEB--X--oB??--?oM-?-X--??--oEXX-----Xo-MoMo--X-MB-ooMB---------M-oE-oEoEB-oE
|--M-?-X-?-----E---BMXM-oEBMoE-?-EMB-o--X---Xo?---Bo?E-o?---E?M----E-B---------o---MTE------X---o--o-TXX--?-oT-B--E-B--oEBTX-M---XBo?E-------oE----B-Bo--?B----B----Bo?---?oBo---?-XEB--o--o--MM--MEMB-M
E-o-EEoBo-M-BToo-B---------o-XMX--M-----ME--oB-?E-EoX---o---?-E---E--X-o--X-M?---?--|-oo--oE-----o---|-XEX--X|-E----XX----|--E---oo--o-B----BEM?-M--------oM-BX--TM--T--XoM--?--o--B----------?----B-X-M
BX---E-----TE|---MBE-----MEM-MB----TE--------o----BT--------X?B--M-----------oB-ET?MXo---?M------T---|?--?-?MX-oEX----X---|-?----T---B-?--T-oX-----BM----Eo?-----|-?-|-E-BMM-o-o-TBE-oMX--oo-TE--B---X-o
o--M-------|-|-MT-X-B-?M----o-o--?-|-M-M-o?-??----?|-Mo?-E-?-EME-EEEX?oo-----MEo-|-XE??-----M?---|--MXE-ME-X---B-------B-?|X-----|--M-X--T|-X----MTX--M-----X----|?--X-Mo--X-M--B|-MMo----MEX|B---B---?T
XE--MEBXX-TX-|To|-E?-B-T-E---------XE---B--X?------|Xo---BE-T---?--o-EEo-B---M---X--?B--oo--EEE--|o--BM-?-?EE?-B-M---X-?-XXE---T-X---B---||X-?T---|??-MM----o---?X---o--B-oM-----XE--B--M-o-T|o--------o
o------B--|--X|-X?--Mo-|---MM---o-Xo--B-M---B-o?---XE----EEB|--X-T-o---?BB---E----B-T-B---M------X---X-B-XB-----------?---B-E-?|----o----X|XXX|---Xo--M--o--E---o-X-X---B-X-EToX-?--M-T----o||--E-?E---v
-o?--T-?-E|?--XE----?E-|--EM----X-----MM----TB---?-?o------BX--M-|B-E-----XoE-oB--oB|----E-?-----------E---o?-----?--o---M-Xo-MX-B--o-----X---XEX-X--B--X-M-?-E--B-T--BX----o|-?-o----|-T--M|X--X--E--?|
XE--M|M--?X-XT--E-E----|XE------M-EEo-X---M-|-?-E---------E----?-|---------B------M-|oM-E-Bo-?---M---?E-E?--M-?Xo?-MX--X-----Mo----?--T------?--B----o--?-?----X-o-|----?---?X?-------X?|---X-XB-o---X-B
BE---X-o--B--|--TB--?-oX----Eo?-E-M-----XX-EXE-------?-M--M--BEE-X-----o-X?B--X--?--XB-BXE----o--oB--o--MM?MoB--?X-?Mo-B--M-BXE---o-EE|----o---M-M-BB?-oE--M-----o-XE---o?--?--?--o?-o--|?--?BME-EX--B-T
B---T---Bo--TXE-|---M--?-o--B---------T-----------T---M----M--TEMB?----------TooT-E-o-T------------B----oT------E-------MTE-----B-----X-------XB-----M---TB------------------M------XTM-X--------------E
T---|-------|--EX-TE---------T-------T|----T-M----|--T--------|-T-----T------|--|---T-|-----------TT-M--M|--T-------B-?--|-----------TT----T----?-T---o--|----------------?----------|--T--TB----E----Xo
o---|---T---|-TT--|--------T-|-------||-T--|---T--|--|---T-T--|-|-----|------|--|-T-|-|---------TT||-----|--|---T--------|---T---T--T||----|-T----|------|--T----T-T-E--------T------|-T|-T|------T----B
m---|---|---|-||--|--------|-|-------||-|--|---|--|--|---|-|--|-|-----|------|--|-|-|-|-M-------||||-----|--|---|--------|---|---|--|||----|-|----|------|--|----|-|----------|------|-||-||------|----?
XXXXXXXXXXXXXXXXXXXXXXXXXXXXXXXXXXXXXXXXXXXXXXXXXXXXXXXXXXXXXXXXXXXXXXXXXXXXXXXXXXXXXXXXXXXXXXXXXXXXXXXXXXXXXXXXXXXXXXXXXXXXXXXXXXXXXXXXXXXXXXXXXXXXXXXXXXXXXXXXXXXXXXXXXXXXXXXXXXXXXXXXXXXXXXXXXXXXXXXX
