XoE----?---M-B-E?B?BMXBMo-X-M-B----?E-E-M-MB-----B?-oB?MEooXM--o?MBM-oB??Mo-BXBE--o-oX?B----Mo-M------?-M?-E--B?-X?B--?Mo-BX?-B---B-XE?MB??--?-??BE-EB-?-?MBE?-BXM-MMB--?BX--EBB---M--XXX-MoE--MM?oB-XMX
|--ooMBXEMoBXE--oEME---ME-E--?-E-ME?---EM?M-?-E-EBEo-Bo-B--o--?-XB--Bo?EBBEX--oXE--?Xo----EBoXM-Mo?-E-E----ME--o-E-oBEo-M--M-XoMXMoB-?--------M----o---X-MoE-XE---BBEB----B---M-BBX--M?EM--EB-M-XX-B?BBM
|XMBB--E---E-?-B---E--M-X----BBM---MX?E--XoB--?XMMM--o--MoB---EE---M--o?--BEoo-o------MEBEE-EoX--T-------?-Bo-E---B?-----?B--MEX-E-?-BE--EEM-XM--?----EE-B-E----BE-?-M-X--M----E?---B-?-B?B--oB-B?-BM-BT
T--X-------------M--E--?---?BEE---o--XEM-?-----E--M-BM-EM-XB-E---o----EEE-o?E-o--M--X---??Mo--oB-|-----XBBME-B-TXBBMBE--B----??o-?X----T----MX?M--BX----EMM---E---o---E-------M---MEE--M--T----B--M--XEM
T-oM-BXB-----M--E----E-o-------oBMBo----B----?---B--Mo--M--BB------E-------?o----B-X-BB------?---X-?---?o-E-E--|---EM?o------------?MB-XB---E----X?-M----EM-EMMM-?-XE--E--E--o-----?o?----X-X?-o---?-o-M
E--B?E------X-?------M---B-----EB?--?-?--X---E-----E--E-----B--o??-----oM-------?--EX-M-?-------?EM----B-MM-oE-X-o--o-M---X??--XE--o----MMMB-----------X?-o-------?M---M--BMX-M-BM---Mo--oM---o-B----EEX
?-----ooXXB--M----BE------?---?---------BB-M--?--------?-?-Bo-E-o-X-M--?E-X?M-?E-----B----?--o----E?--M?-E-o---Mo-----MB?--M------o--B-----EMo---?-BMMM--?-M--o------B--------?X--E---MM---E-----M-----?
---?---o-----?-oMoo---EM??-MME--?------B--E-o-B-------E--E--E----MXX?-Bo--B--E-o-oMX----E-M-oM-M-E-M--o-?M--------o----------o-?--?-M-oo---B--?----EoM--EB-B--------------o-----BB-X-----?-?----X------v
B-oo--o?-E--B-ME--M-XBo?---------?-----o------E----M---M--------M----oBM?-E?--XM-----X-??--ME-M--------o-B-oE-M--o-o?-------XMXT---o-XB?------E-M--B-----o-M-?-----X-B-----E-B-X-ooo---B?----E--o--X-X-|
?oo------?T------M----E-B-Mo----X----XXE--------Eo-BMoBT-oo---E--o-o-oo?o---MBo---M-?B-?Bo--?EE---X-?XXo-E--M?-E-o---?--MM-----|?-----------?-?---BMB--?----M--X-X--X------?X---B--B-X----B-----??---?--
M-MB-?-?BM|--------M-X-?-------MEo---o--B---------B?-M-|EoB---------E---------E--XBE---o-M-------E-o--BB--?------o--E-?o-----E-Xo---E-M-X--B-?-B---E?---B---EEEE-B---E-E-M--M?-----MB---M-?-oo---M-M-M-E
B-B-B-M-E-X--MTMoX------o-------M----Bo------B---?o---oXEM--------E-oX-B----E--Xo?--B--?-??-XM-?X---o----XoX----M--------E---BM-?-E-E-E--M--B-----o----B?-oB----B-o-X--BM-EoM------B-TX-E------B-----E-T
?-B---ooBoo---XMBoE---X---XB----MMB-----------B---E-?---B-o---X-X----?B---M??----B-M-E---------M-B--?-o?-?---?--XX--B-?----M---oM-------?---o?---?BM--o?-o-------X---B-?--B-E--B-MX-?|-oE---EoMMBX---o-?
|X---MEo------MB-----M--XEE-X----o--o--X?-----E-BM-E--E-M---E-MXE----o---------B--M--B---o--MMEEB-XX-oo-X?M---XMM-Xo-XMoE-----?o---MM?E----M-------M---?---M-------?X--?o----BE-----E|---o-BMo--------Mo
m-MX?o--XoB-B-BMoE-M?B?-oM?X-EB--oEXEME--oE-?B-----?--oE-o?oMXBE-oB-E-M-----EME-oEME-BBBM-?MBBBE?Boo--E---MB?MM-EXEB?-B--E--?E-B---oB-XX?-M?----BMoMXo-o-?Eo-o-Xo-MB--X-EM-o--MXX-Bo-XBoME-E---o?-ooEX?o
XXXXXXXXXXXXXXXXXXXXXXXXXXXXXXXXXXXXXXXXXXXXXXXXXXXXXXXXXXXXXXXXXXXXXXXXXXXXXXXXXXXXXXXXXXXXXXXXXXXXXXXXXXXXXXXXXXXXXXXXXXXXXXXXXXXXXXXXXXXXXXXXXXXXXXXXXXXXXXXXXXXXXXXXXXXXXXXXXXXXXXXXXXXXXXXXXXXXXXXX
