B?M--BBX---??-XXoX-?XXXXM?-M-?oEM-X-M---?--M-oX---MMBBBoEE-MX-E--------X-Eoo-oX-M-Xo-ME--EXXoBB-?BB---oE-M--o-EB-B--?Xoo?E-EMM--B?EoXM-E-o-MBoM-BXo-MoMXoBM-X---X?-E----E-M-?o-?-M--oB-XoM--?--?M-o---MM
Mo--E-XMEEXE?----MMoB---B-EoBBX?--XM?---???E-?--?X-?M-M-?--MX---?-Mo----M--o---o-?EoMEB?-BBM-oBB-B--B-X--X--Bo-o--BEX--MXMoEM?M---X?BEBBMBoM-oBo-?--EM--XB--E?-o?-B---EMX-X-X--M---BM-?-EEo----?--BEM-B-
|M--?EEXoE---o----o---oM-BooXM---M-T-oE-M-o---XE-o-B-o---o------------E?M?--X-EBE-o---oM-X---B-?Bo--MM-EE---B--oM-M---MM-?-M-XXMX-X--X?M?--X-oM--X---BMB-E-EM-B---E-EooXM---MEo-oEMX-?MoX??--X-?-BBM--E|
?E--o--oB--?-oo------E-Xo-oo--X-o-B|T---M-M---X---BBB-o-M-B----E---X----E--Eo--X---M---B----E---?--M---X?-----?oo--B--------E---TB?-------E---B----------BB--T-------BT---------------B?-BE---?------E-o
-----?------X-------B-X----E----o--||T-E--o-o--BBE---o--oo-o--o---E--X------M--M-XEBB----?------M--B--M---?------EX---E--------EX--M-----E----?---?-o-M--?EB-X----XB--X-EB-----o?---B----E-EB-----B----|
T----------o?-?--B??-E?--T--X-E--Bo|XX--X-------oo-T-o----X--?-o-MB-M?----------------E-X--Xo-MM-----?--------X-?---------XX-----M--E-----?X--o??--BB------Eo-------o---o-X-o-E--M------XB------B--?---?
X--E-XM-E-------o-o--o---|-----o?-EXEE-----oo------|o-------XM---o----oo-T?-E-oM-------o-o------B-BB-B-o--?---B----X------Mo--------B-oE-----M---TXoM--?o-XM-------------M----?---M--------?---X---E---X
oB------?MB-X-E?----M----|M---Eo-B---------------X-Xo-X-X----BEooB---T---|-------------?--?Mo--M-o-??--?-o---M----T----X----B---B-------E----BXTo|o?-B-M-X--XE-----?-?-M---ET---M----------o--M---XMo--v
M-?ME---M--o--M----o---oX|--B-E--M-B-----B--?---E--EE----X-o--M?-----|Xo-X--T-X?-B------Xo--------E--T-E-?-X--X---X--?--M-E--?EBoM----Xo--ooE--|-Xo-M-------M-M--?To-?-----B|----B------XEB-BB-E----M---
?----E?---B--o--o----o---XT-oo-X--BE--XE-B--E--E--o-MX--BTE-o------E-T-E----|B------oE-o---??------o-|-MX--T---X-?-------T---?----B--B?o-o-----X--o----?M-MM----X-|---?---B-X-B-X-E--?---------M----M--E
?-?M-B---M---ME-?---Xo--M-XE-?oEBE--B----o-M-M-----M-Bo-M|-B-X-------|----o--B---ooB-M?---M-M-E-----XX--E--|--------o-X--|M-M-o?---X-E---o-BE--?X---MMM--E-?-o--?MX-oE--X-B-?----?--E-----T-X-----M--XXX
o-----------?M-------?-E-----------B-------?--------X----XE----o--E-?|o-?X--X------M-------T--TTB--?--B--XXX--B------X---X-B-X-TE--------M-----M--X--E---M--X------EE---T----M--X-M-oT---?|-oX-E-B-T---M
ET---------E--------M----T--oT----T-------B------TB-----B----M--T----X------o--MTT----B--?-|E-X|-M----E---M-----E?---T---------|-?----E--------------T-B--------oB------|----B-B-BB-B|----X------BX|---E
o|TTX-----T----M-o--T----|---|-T--|--------?--T--|-----E--E---T-|-----T--T-T----||-------T-|---|--E--------------TTo-|------?--|---o-?----X---E--X---|---T--E-----------|--T---------|------T-T---M|---B
m|||------|----T----|----|---|-|--|---------T-|--|------T--T-T|-|--TT-|--|-|----||-T-----|-|---|------TT---------||--|---------|-----TT--------------|---|T-------------|--|---------|--T---|-|----|TT-M
XXXXXXXXXXXXXXXXXXXXXXXXXXXXXXXXXXXXXXXXXXXXXXXXXXXXXXXXXXXXXXXXXXXXXXXXXXXXXXXXXXXXXXXXXXXXXXXXXXXXXXXXXXXXXXXXXXXXXXXXXXXXXXXXXXXXXXXXXXXXXXXXXXXXXXXXXXXXXXXXXXXXXXXXXXXXXXXXXXXXXXXXXXXXXXXXXXXXXXXX
