XM-Boo-B-M?E-E-?E-MMXXB-o--?XE---ME-MX?--MMX-BMBB-o-oM-?--B??E-E-o-X--E---XXMMXE?B-BBooE?XB?-BX--?MB-?oE?X-o--EEo?o-X-BXoMo-BoE?MoBBBMEoEB?M-E--EoXoMo-MX-?-?--XEEoM-M-?-XE-B-???E?E-E-?--ME-E----B---XB
BB-E-X-?--E?-BXMMM--EB--E-MXE--Eo-XoM-??-?M---EM-X--B???--EM-BM-oM--o-M-XXX-EEXoB-X--B-----?------X?-?X-E---X-XBB-E-o--XXXE?E---X--??-o-X-?E?EX--o--oX---MM?Mo-oE?---EX--BX-EX?X---ME-----X---M?oXoo?-oM
|?B?-E-M---E--XM-o--ME-BMEMo-o---oBM---?-?-oBBE-MX-B-ooooM-XB-o--BM-BoB-----MoM-X-?Eo?XM---M-oXB--M?-??M-EE-M-MM-XEMBXM-?----M-o-?MX--B---XMMo--E---oX--oM?BMM-??---?-?X--ooX-M---B?-o-M-M---BEo---E---T
B---B--EE---o-E---------o--E?---E--oEX-?-E-E--T------X-oM---EM?E---o-XE----M------Xo---------B-Mo-M-B--M-E---?-B---MB---BE-M?E-o----M----MB--MEo---B--o----B-M----BE--BX-XB-X--ME----M--?o---B-B---B?XT|
T-----BE-X?---EB--X--XEM--EEE----?-E?E---?M-X-X----?X----XBM----MXo-B--B--------oM?-----o------B-----o-EM--E--XB------E--E-BE-Mo-----Mo---?---E--Bo-o----------o-o---------XE---------M-B--X-----o--?E|-
M-?X---o-B----M-X---EB-B?---oBX-o-o-o-B--E---BoX-o?---B-X-?-X--o------------o-X----E-BX---T--M----?-------B--------X---B---?BX-?-------M--?----E----?oX-X--M---E?-------o-B-------------Eo-o-?X----ME?|B
B--?---B?----?---BBEB-X-BB--M-?E----M---X-E---?E-----EoX-MEE--B---o------?-X------BM------|-?---B--?-----XMM?MX-----MB---B---?--o---M-E------Bo-o-----B--X--X---?X-M?X-EM-?----o--Xo--o---T--o-XM-Bo?-|M
M-o----EE--M-----?-B----E--------XBE-??-M--BE---X--X------o-Xo--BooXB-X-B-X-o-XX--E---XXX-|o-M--BB--M-XEB--MMM-----E---?---?--M-o----Mo----?----B----?-----B---oB--M?BX--MB--XX--??M--E?M-X---X---E--XXv
|-?E-?-E------B-E?-E-M-B--X----o----T------------EEEoE---?M--o--E----M---X-M--M-E---M--?--X?o--o?-MM-M-o-E-B---X---M-X--XM--E--E-E?-M-?--o-BB----o-o--?MT?-E-?XB-EM-EM--X--B?-----B-X--EEo---oM-------?B
-X--X--------BMX---E--------X-------X----E-B-?X---?----X?---oM?----X-MX----EXX-?MB--MMXE--M-oX--E-----o?--?Eo?---X----B-o------M--MX?E--o-----M---X-M---|---X----o----X----M--T--X-----o-M--B---X----EBE
?-oBo----o-?----oEMMM---B--MM-oX-X-X------B----XX---X-?-MX-BB-?-------------?o----XBE--o--M-?M---Xo---B-M-M-o------oMEM--?EE--TE-?-M-------M----o--E?-E-----E--XX----?-B--X--MX-?---MX-?-------X-X-?M-Bo
----B----BX----TE?--?--E-E------XE---BMB?o---?--BoX-----o-o-------o--?-X-?-----XEMo?E-M-------EB----o--M?----XMoB----B---B-T-BX--o-------EB-B---EB-ME--?X--X----Mo-M--MT?--E-MEE---o----B--o---B--E?oX-T
MT--M--T--ET--?|--E--XE-X----E------Xo--E?--X-M--------------EEo-?---------MBBT-o-?-?o--EEBo------T-M-------M--o--X--o---EoX----E--?-X------?------E--?-?-?-M--?------E|---M------B?--oM-----B-oMX-E---|
B|-X---|T?-|M-B|-----B------M-XB---E--B-oE?-M---E--------?M-E----T------------|--?-X--------X-o-Mo|B-E-E?M--M------B----BE---EXE----M---X------?---E--B----B---EM----M-|----E-----ToM--M---X-T----Mo--oM
m|--T--||--|---|------T------------------------------------------|-TT-T-------|-------------T-----|---------------------------------T---------------------------T------|---T------|----------|-T-------X
XXXXXXXXXXXXXXXXXXXXXXXXXXXXXXXXXXXXXXXXXXXXXXXXXXXXXXXXXXXXXXXXXXXXXXXXXXXXXXXXXXXXXXXXXXXXXXXXXXXXXXXXXXXXXXXXXXXXXXXXXXXXXXXXXXXXXXXXXXXXXXXXXXXXXXXXXXXXXXXXXXXXXXXXXXXXXXXXXXXXXXXXXXXXXXXXXXXXXXXX
