----------X----------------------------------------------------X----------------------------M---------X------------?----BB----M----------------o--------------------------------------------------------
---------B----------------M----XX-M-----------------------------E---------------------------------------------------------X-----------------------------XX-----------------------------Xo---------------
----E-XX-E----------------------E--------------------X----X---------------------------------------------------------X-o--B-----------------------o--M---------------------------------------------E-----
--?------------o------------------------------------X-----------------------X---o-----------------o---------?---------------------------E--------------------------------------B-------------X----------
---------------------------X------------------------------X----B---?----------------------------------------------o------------------------------------------o------------------X-----------------------
------------------------------------------------------------------------------------?---------------o------B----------------o---------------------------------------------------------------------------
-----------------------M--------------------------------------------B---B-------------------------------------------------------------------------------------------------------------------------------
-------------------------------------------M----------------------------------------------------------------BX---------------------?-----------------------B-----------------------------------------?-v
-----------------------------------------------M-------X-------------X-----?------------------E---X---------------?---------------------------------X--------------------------------------------------f
------------------------------o--------------------------------------------------------B--B-------B-----------------------BM-----E-----EX-----------------------------------------------------------o--f
-B--------------------------------B-------------------------------------------------------------------------------------------M------------------------------------------------------------------------f
-------------B---------------------X-M------?---?--------------E-----------?-------------------o----?---------------------M-----------------------------------------------o------------?---------------f
--------------------------------------------------B----------------------------------------------------------T-------------------?--------------------E-T----------------------------------------------f
-------------------M--------M---------X-----------ME--------------------------T---------T?-----------------X-|-------------------T--------------?-------|-o--X------------------------------X-------X--f
m---XX---X-XX--------------------------E--------X----------------E-------X----X------X--X-----------------X--X-E--?-------X----X-X-----X-X---------XX---X-----E-----------------X-----------------B----f
XXXXXXXXXXXXXXXXXXXXXXXXXXXXXXXXXXXXXXXXXXXXXXXXXXXXXXXXXXXXXXXXXXXXXXXXXXXXXXXXXXXXXXXXXXXXXXXXXXXXXXXXXXXXXXXXXXXXXXXXXXXXXXXXXXXXXXXXXXXXXXXXXXXXXXXXXXXXXXXXXXXXXXXXXXXXXXXXXXXXXXXXXXXXXXXXXXXXXXXX
