--------------?-------------------------------------------o----------------X-----X-------B---------o----------M------B--------------E------------------------X?------------------------------------o----
------------------------------o---------------------------------------------------o-o-------B---------------------------------------------------------------------E-----------B--------E----------------
------------------------------o-----------B------------------------?-----------------------------------B--------------------------------o------------------------??----E------------------o-------------
-------------------------------------------o------E-----------------------------------E--------------------------------------------------------------------------------M------B-M-----------------------
------------E-----------------------------------------------------------------E--------------------------------------------------------E------o----------------------------------------B----------------
---------------------X-------------------------------------------------------o---------------------B------------------E----------------------------------------------E-----------------------------X-X--
--------B------------o---------------MX----------------------------------------------------E--------------------o-------------------B---------------------M---------------------------------------------
-------------------------M-----------------o---o--------------------------------------------------?-----------------------?-------------------?--------------------------------------------------------v
------------?-------------------T----------------------------------------------E---B--------------------M--------?-------E-o--E-------------T----------------------------E-----------------------B---o-f
----------------?---------------X-------------------------------------------B----o--E-----------o--------------------------------B----------X--?--------------?M---------------------------------------f
---------------------------------------T----------------------------------------------------------------------T---------------E------------------------------B-----------------------------------------f
--------------------?E-----------------|---------o-------------------------X----------------o-----------------|--------------------------M--M----------------------------------------------------------f
---------------------------------------X----------------------------------E-M---------------------------------|----M--------------------------------------------T-----o-----------------B------------o-f
----------------X---------------------------------------------------------------------------------------------|---------------B-T----E----------------M-X-------|-------------------------T------------f
m--X-----B-----X--------------X--X-----------------------X------B-----------X-----X----------------------XX---X--B------X-------X-------X--------------------X--X---------------X----?---BX------------f
XXXXXXXXXXXXXXXXXXXXXXXXXXXXXXXXXXXXXXXXXXXXXXXXXXXXXXXXXXXXXXXXXXXXXXXXXXXXXXXXXXXXXXXXXXXXXXXXXXXXXXXXXXXXXXXXXXXXXXXXXXXXXXXXXXXXXXXXXXXXXXXXXXXXXXXXXXXXXXXXXXXXXXXXXXXXXXXXXXXXXXXXXXXXXXXXXXXXXXXX
