X-M?E---EEM-B-Xo----oB-----oEM?X?E-oM----B?-E-E-EEBMoM-?oo-M-B-X--X----M-oM-EX?-?E--B-MEXMXEo-?o---B--o-?-Bo--?X?oX--X-MX-X--E--oBM?-Eo-?-----B?XMo-XBoM-----X--B?EE?-M--M?E??-X--?MX---BM-MMBB?E--?EEEB
M?---M-?M--EM--?EM--X--X-oX-?M-EE-?---?XEX-o-?oE---BXE-o---o-EMo--E-E-X-B-MME?oB?Xo?MBM--X--M-?----MBX-o-M-MTMX-XX--XoEBMX???MB--?BM---BM?oMo--E----?Eo-?X?-E--EMEM?B-BBXB-E-M?----oM--M??MB?-B-X?o-E-oM
EM-----o??XMEB-EB-EM?M-M-M-M-?----EX-o-X-?X?--B?M--?XXB-MX-B-XME-B-BEBM-?BMB-o----?ooBoBBEMXB?Bo----X-XM--o-|-M--B--E---MB--?---EoMB-MEo?-BXE---X?oE--B-X---M-TBMM-oXE?o--X?M------?Eo-M-XM---o---o--X-X
MMME-?--E-o----o-?BoBM--M----E-M------X-------M-o---E--X-X?-MX-o------?-X-?--B--o-----o-X---o-----o?--oo----|o------XEM------oB-EBE-?-M----E--E-----X---?---B-|----o-----oX--E--B----M-------oo--?MM--E?
?-M--o-MoM-M-X-?E---?-----EMB-----oM--M?-MM--EEX-M-EoX-o-------oE----?-M--------oMM?-ME---o-?---B--------X--X------oE---MM-----E---X---X----X-EoM-o---M----?--|--B--MX-o?------BEo---o---X-o-----B---EB-
XE--?-X----------oB--oMB-B-E-X---?----oM--?M----o--M---?---B---EB--?---?---?--oXo?-BEBMX-o--M--X--B--o?-X--X---M--E------B-EBB-E-----XE-oX---o?-E---o--Eo-XM--|T-----oo--M----------X-------EE-----o---|
o-M-o-------?o-??MM-----B-o-E-XEM-Eo-------MME?------E?-E-oo---------?-----?-X--MoME?-o----X--E-E-----M---Eo----T-M--oo?--?----o?--X---M--X-X--B--EM-MM---E-X-X|--X-o-o-?-o----B-M---o-?-X-o--?B-XE-Eo-M
?X-M-B-E-----o--oT---BM---o-B-E--oE----?EB-E----?--X------M-----MX--E--B--M----M-o---XE-----BM-T-B--------?MXEMo|-----------------B-?M---B--EB----o-E--oEBEo-o-|-M?-M--M?M-?------X-X--oo---E----------v
T--o--B------?-E-X-EE--?XX-----XE-E--oo--o-o-Bo-----Eo--B--B--oEME------B--B----M---M----------XM--o------M----E|M?----E?BEo---M-----B--B-B-------EE---E------oX?---M---MoX-?o-----??--B-----o-Bo-?-E--M
E-B-BX-E------B--?X--M-----X------?---M-X---X-?--X---?-----------E--?BM---??-?MX-------------E--E-?--B----B---X-|E--------?Eo-X---X?----oB---X--B--M-BooBE--oo------?------?---BE-------o--X-?-T-B??--M?
o---E---B-?--o?--oE---B-M---M------o------?----BE----B--M-E---Xo----BB------E--B-----BXM-X-E-B--E---oBo-MM-X-oMEXM?M---E---------ME--B----M-X-E-B--o-o-B--BEME--?M-X?B-B---EME----M?XM------o--X-----B-?
B-B??-?-?-M---BX------MBo---BM-M-BB--X--------X--X?oM--------E--T-EX------X--o-BEXTM--B-----BB--------M--EXoBB--E--B-X-ooBX-X-----o---E--B-o--Mo-?o-X------?------oM-o-E--?---oMo------T-XM--M---?-oE--X
T-------B----T--B?-E-X-B-E-EMMM-------?--------o--o--E-MXB-----X|---o?--B---B---M-|-----T--?-M-X-o-----M-MT--------E-----?-----o--------?-------?T---M----?----Bo--E--oTo-E?--------M-B|--o-----E--MM-M-
MT?------M--?|---o-------E??-o-E?-o------M-MXEM-E?------E---?--E|-X-o-X---XM----?-X-Mo--|----M--??-XB-TBX-X--M-----M-M-oE--M-----MXoE---B--?X---?|-----T----------o-T--|M------T----o?-|-?-o--oB-------B
m|-----------|---------------------T-------------------T--------|-------T-----T-----T---|---T---------|------------------------------------------|-----|------------|--|-------|----T--|---------------M
XXXXXXXXXXXXXXXXXXXXXXXXXXXXXXXXXXXXXXXXXXXXXXXXXXXXXXXXXXXXXXXXXXXXXXXXXXXXXXXXXXXXXXXXXXXXXXXXXXXXXXXXXXXXXXXXXXXXXXXXXXXXXXXXXXXXXXXXXXXXXXXXXXXXXXXXXXXXXXXXXXXXXXXXXXXXXXXXXXXXXXXXXXXXXXXXXXXXXXXX
