-----------------B------?------------------?--------------------------------------------X----------------B---------?--o---------------M?----------------------?-----E---?----------------------?--------
----o--------------------------------o----------B------------BB-----------------------------------------------------------------------------?-------------o-------------------------B-X-----------E-X---
--------------------------------------------------E-------------------------------------o---------------------------o--oM---BE-----B----------------------B---E--o--------------------------------------
------?---E-----------------M---o-----------------------B-------------?----------------------------------------B------------------------o-------------------------------?-------------------------------
--B-------------------------------E-----------------?-------------------------o---------------------------------------------------X---------------------------------------------------------------------
---------------------------------------------M--------------BB------------------BX-------------------------------------------------?--------------------------M-----------------------------------------
--?-------------------------B-------------------------------------------------------------o-B-----------XX---------------------------------------------X-----------B------------------------------------
------------------M-----------------------X----------------------------?X-M-----------------------------------------------------------------------B---------------B------------------------------------v
-?--------------------------------------o-------------------------------------------------------------------------------------?---------------------------B---?---------X-------------------------B----f
--------------------------------------------------------B-----------------?-------------------------o---------------------------?-----------------o----------------------------------------------------f
----------------------------------------------?---?----------------------------------------------------------------------------------------------------M--------M--------------------------------------f
----------E-------------------------------------------------------------------------E--o----------------------------------------------------------------------B--------------------X----------------X--f
--Eo-----------------------------------------------------------------------M------------------------------------------------------?-------------------------------o-----------------?------------------f
-----------------B------------------X--------------X---------------X---------------------------------------------------------------------------------------------------XX---------T--------------------f
m---------XX----------------XX----------------X-X-------------------------X----------------X-----------XE-X--------B-X----------------X----?-----------X-X---XX--X?------X--------X--------------X-X---f
XXXXXXXXXXXXXXXXXXXXXXXXXXXXXXXXXXXXXXXXXXXXXXXXXXXXXXXXXXXXXXXXXXXXXXXXXXXXXXXXXXXXXXXXXXXXXXXXXXXXXXXXXXXXXXXXXXXXXXXXXXXXXXXXXXXXXXXXXXXXXXXXXXXXXXXXXXXXXXXXXXXXXXXXXXXXXXXXXXXXXXXXXXXXXXXXXXXXXXXX
