?--oM--oBMB-?-X--BoEE-E???XEE----o-M?Bo-E-XB--o-o-?XE-EXM---MEBX-EXE--X--?----oXM-?-X--?-B-oo?-X-M-??---X---o-?X---XBo--o-B--XB?Bo-E-o---E-EB--o-EX--o-?-X?-XBoEBE-oo---EB-EBBEoB-B-B-BoBEo-MXEM--XXBEBE
?-X?EXo?B-E----Mo-M?XBE-XBM--BBBX--E-B---B-?-XMo-EoM-?oX?B-MBM-M--B-o-oEMM-EE-X-XoB--MME----Eo-BBMX?-B-E---XMB-?-X--ME-----E--o----B---?--MX--B-oBX-MoXMMB---XB--MoBEBBB??-o?X-Xo-o-XMBE?o--X--?XMX---E-
B?-MoBoX?Bo?MM-??B-??BoM----E--MX--X-M-X-E--BX-MBEoM----BMo---Xo-oM-X-?oE-EXB-o?Mo-MM-?-BM---o----o??--XE--o-E?-?-BX-M?BBEMXo-o-B?XME----EE-oM?M?----E-BB-?-E-----E?M-oM--?M-MB--X-XEEoo-MBB?-XX-E-BoX?M
o-o-E-BBB?E-o?MXMoX-E??-EX--M--o?XBo?B?-o-XEX-B--o--o-M-MMB--BEEX-o----oBM-X-BE-?--o-M-B-o-Xo---?XXoo?--X--X----?B??---EEM--ooX--M?--EX-XXo-?-oX--?o---X---B--XXX-oXMXMXB-oo-o-MM-oE?--?M?-XX--?-BM-BBB-
o?o-B?o--XM-XBX-EBX---?-B-BB-o--X--X-o-o?-EM-??----MoB-EX---X-E----oBBX-MMB--o-X-MB-?B---o?-----?---M-XoBM-BX-M---EM---?X--B?M--X-EX-X-B?-M-MEo-X--?-XE-?EXo?XE-EB-M-B-?BE-B-E---EMMo--?XEMX-Mo-o--o-o-X
?MBMX??--B-M---o-B-oX---MXoBooMBEX-Bo---E-MEE-MoB-M-X-BXo---XM-Bo-E-oXMMXB-E-B--o?----o-X??MB-X?EE?-E?-o-oo?o?E--oX?oEoE--Eo?-EX--B---?---BE?B-Eo-?BX--EX-B?-?-X--XX-M---X?--oEMX--?o?--XMMBEX---B-X---B
M---?-------??MEX--o--XE-XoM--EEEBoXXBE-?M--XBEMM-BEXE-B?---B--M--M--oM-E-o-??-E-Bo--MEXo-B--?EEM-?EoEMB------M--MXo-XM-Xoo?--X----X-MooX-ME-B?-X-Bo----B--oBBo-?-EoB-EE-E-----Xo?B---?-?--EMM--X-M-X-BE
|-oXXB--XB-EX?---XME?Eo-XE-E---E-E-XE---oE?X-?-?oEEX-?oB---B-Bo-B--X-MEB?M?Eo?o-XE-BEE---?EEMo---BXX--BBE--EBEo-EXM---MXBMBXE----o-X--E-XoX--oM--B--Xo-BEE-X-o??BB-----oo---oEB--o-E-B?-XMo?-EB--MEo-o-v
?o-X---?--XMEo-MBXo--?B------X?-o-B----E-o--M--B?--M-BEB---B?-?o-?M-MXE-MoB?-X--XBEBEB--X-BM--BEE-XMMXBoo---BM---X??---MB-B-EXBEM---oE-EoEoMX-?B-BB---?--EEB?o-----M---BXB---?EXE-XBX-B-BXMME-E--?B----o
M-M?-?E-B-ME--?X?-ME-oM--?oEo---ME---?-M-M-Xoo--?X----MB-?-B-EoB--oB??-?X?--oo-EB?BX--o-o??ME?-MEoB---E-o-ME---oEXo-Mo-?M--E--BMX---o?X?MM-BEX-Eo---EEB?--E-MX-o-M-?o-o-o--?BX-M-X-o-MM-o-oo-X-o-E-oB?EB
M?XE-EXoX-oXoE---B-BBBoX--X-MoXM---M?-BooM-XME-XX?-??-??Xo--X---BM-MME-E-EoEX---Xo----E-EEMo?--EXMo-XEBEoB??MEX---EX-MM-XEo-o---X-BB-X-MM?MXX-M-M-BE-oB-EEXBoE-BBo-E-X-o---XBEE?---X-MB----B-oEB?E-o?---
oMM-----EM-EM-E-XBB-EB-E-BEBE--XX---EBBB?oX---B-X-----X----M?---BXB-E?EXooB?MM-B--o--M-o--M-??EXE-EXBMB?Xo-X--XM-?oB-XMB-?----oM-X--o?XEEBBEBM?MM?----oo?o?M-X-?Mo--EEBM--M-B--X-o-oMX-XMBEo-o--?B-?-M-E
TEo-XM-E-B-o-X-EoE???-XX---oMo--BE-EM??-MX-M--o---oXM--X-EM-o-M---Mo-XXX-E-E--M-oB-----B-X--M---oBoM-?o?-E---B-B-o---M??----B--?M??MoBEX--?--MooEo-XBM-??E?-X--XBEB-BBME-o?Bo-E--X-oo-BXE-?--?EBoMMo-X-T
T?XM-oMoMoE-X-MB-oEMEEoBo-?-B-M--MMMM--?XBXBM-B-EX?---oXE?XoXE--E--MMMEX-oEB?o-BoEM-X---E-M-o?--MX-BE--oE-X-XE-E?X-o-MEo-?-?--?-E?MX--o----ooEo----M-E-MB?-Mo--BoB--EB?EE--?--X--B--EMX?BMM-E-------EB-B
m-EB--BBXXBE-EM-E---XE-XE-?BX-M-oM-MEo-?-M?E-oooME-B--B---MM?-XX-oo-o-?-?--X-E?XMM-BB--EoX?EMB-oEX-X-ME--??-XX-BEM??MXX-E--MM?E-----?--o--M?--X-B?---X-EE--?---BEM---EX-EEB-X-?M-X-o--oXB-M----E-oM-MMMM
XXXXXXXXXXXXXXXXXXXXXXXXXXXXXXXXXXXXXXXXXXXXXXXXXXXXXXXXXXXXXXXXXXXXXXXXXXXXXXXXXXXXXXXXXXXXXXXXXXXXXXXXXXXXXXXXXXXXXXXXXXXXXXXXXXXXXXXXXXXXXXXXXXXXXXXXXXXXXXXXXXXXXXXXXXXXXXXXXXXXXXXXXXXXXXXXXXXXXXXX
