|-B?XXMEB--oX-XoXM-E--MM--MX----------M--ooBo--BT-EXX--E-?-o--M?o-?--M-?--E-MBM--XXB-XEXB-EM--oB-?XE?Moo?-E--B-oE-o---?o?-XX-B?--X-?M--?X----XE--oBooXEB-X-oME-oE--XX---?oEoo-?o---Bo--?EMX-B--BMMoBEX-?
o-XEME?o-EoB--BE--?oBM---M-B-?---XB--E?---MXB???|BXBB?o-M-B---M-MB-oE------EBX--X----?X--o--BM--BE--o-?BX-X---M--Xo-oB?-M--oB--BoB--E----?---oBEX-B-BMX-M--BM-M-Mo-BEBX---o-o-E-ME?--BEo-EM--E-o----o-Mo
B-?XEB----o---X-?o-B-T?--ooEXEM--?M-T-?o---MXBB-|-o-BM---EM-----E--MEo-X-ME--MoE--?-B-M?-BBMo-?--E----MMXo-EBoBXBo-B--oX-EEEoXBETBEM?X----Xo----B----oEXo-M-Xo-MM--E--BEo--------?-XoX-??-B--BB--M--oEB?
o-X----M---------X--T|------?o-----?|--B?----?-?|XE----M----?------------Boo---o--E----BBB-o--------?---------o--MB---E-BXB-----|Bo-M----B---E-----T-o---XM-o-E--XT----M---M--o-----E------M--?-M----X-|
-----o--------B-XoE-XX-MMoXM-M------X--E---T-M-?XM---B-------MM-?-------E-oo---o-X-E-----?-M---??--?E--?-??E-B--EB-ooX-o--E-M-M-|---oo-B---B-M-----|?-------M---?oX-MB-----E--MX-----M-?BTB-B-o--XB-M-?M
X--E--M--X-o-B-------------TX-?-M--o---o---|---B--TT-EX---X-----oE-E--E?-o----------M-B-BBX----M-E---B-T--EB-TEX--M--o------o---|---ET-----------B-X----?-BE----E-?XB----E-??--T-MMoMo-TBX--?----------?
?--T-----E-B-----?-E--o----X----o-TM--B----|---B--T|---?B--o-X--ooB--M-o---BX-EE-XXE---EB--?--o----MB--|-BM--X------?M?---?-----X--M-|E---XTX?E-XBB--X--E-o------?--o----B?M-E-|E-M----|-E----o?---M---M
Bo-|----oM---M---EX-B-M-----B-B-EM-?oB---Bo|----M-||----M--------B--------B------------BBXMo--oM-------|-o---------?-B--M--XB---oo-B-X-B---|------?---XMo---M-----M--B-?-E---?E|-EB-o?-|---XE--o--?--M-v
|-T|M--X---?o--?---?-----X------BBX--M--o--XBM--o-XX?--?-o--B--X----oB-M------B------B-ME--o--ooM-M--E-|--B-X--B-B--M--?-X-MM--B-M----T----|---------BB-M----X----------X-X-o-?X-E-----X--?------B--M-oX
M-XXM?X---o?--B-B--?-----E--E-B--o--B-o--E-M--TX---B-XE----?E---------?-------------X-Mo-X-M---------MXXEE-----?M--M--?------B---?--Bo|--M-|?--oX----o---o--ME-?-?--X--------B?----o-E--?------------E-o
oB-----?Bo---XB-?---MXX?--E--B-?o-X-----X----M|--------MX-E-o----E---E-?-Mo--EE-BBX--?---------?X--M-B--E?--Xo--o?---------X---M--EE--|----X-X-T-M-B-B-X-MoB-----M--E--BM------oMBXT-------M----E---?-X|
XB-T--B--------M------M------M----oBE---------X--B-----T-X------?-B-oo--Bo-----M-----TB-B---?--E?-X-----o---M-MBE--X----?-M------To---XT?-Xo-B-XM-MT?------------E--B--M----EMBE--T|E------?---T--M-?--E
B--|--B--B-----E-T--o-----TE-------E-?------??T--------|-----T---------------B-----?-|------------To--------------------E----E---|--TT-|-E--M------|-----?M-X------M-XB--ET-----o-|X--Xo--EB---|-?o-----
MMX|M----------M-|---T----|----T-T-----T------|---T---T|-----|-------T--T-------T----|--o---T-----|-------------T-------------T--|oX||-|---T------T|T-----------E---------X---T-T-|TT----------|-----T-X
mT-|------T---T--|---|----|----|-|----T|--T---|---|---||--T--|-------|--|-------|--T-|T---T-|-----|-------------|-------------|-T|--||-|--T|--TT--|||--T-----------T------T---|-|T|||---T------|---T-|-M
XXXXXXXXXXXXXXXXXXXXXXXXXXXXXXXXXXXXXXXXXXXXXXXXXXXXXXXXXXXXXXXXXXXXXXXXXXXXXXXXXXXXXXXXXXXXXXXXXXXXXXXXXXXXXXXXXXXXXXXXXXXXXXXXXXXXXXXXXXXXXXXXXXXXXXXXXXXXXXXXXXXXXXXXXXXXXXXXXXXXXXXXXXXXXXXXXXXXXXXX
