BBE?-?MM--ooMXXM-?MB--B?M-MB-MoEM-EM-E-XMM----o-?o-?MB-?M-X??---E-E----B----?-BXM--EBE-EX-BEX?B-o-X--oX----XMX--o-M-?MBEXX----o-MB?-o?XE-B-X-M---?-?-MMM---E---BooBEooX------BMXE--M--o--E---BEM-EEB-B-?
TB---oMEBB--X--BX--o--MX--X-M-----E-M-B---?E--o?oME-MBME-X-oEM-----X---BXM--o-X-X---???M?BBoX-o-M?-?M-?-o-ME---o--oX-E?-M--E--M--X--oEE-B--?---------M-ME---E-B--o?-?EE-EoX--X---?-X---E-?E?-B-----X--?-
E-o-o--MB-E-X-o--o-o-?EEB?o---?XM-o?E?-?M-B--EXXo--E?oo?-----o-M?-B---T-MM-oE-T??X-o-?M-BE---?-BB--?-o--oTB--X------?---o--MMX-B-B-BM-BX--o--E---o-?M---?oBEBEBEEX??---?Eoo---B--M-E-B-B-o-EB-E--E-MXE?|
E--?--E-B--M-X-M----?-M-?--M---?-------X?--?----B----oX-ETM---oo-?----|-BB----|----M---M-EM--o-BB------o-|--T-------M--E--------B---X--B?E-M--M---?EB----B--??----M------?-EM--M-----E-----M-------M?EoE
----------X---?-X----E--oo--XXX-----XM---oX--o-MTo-----X-XB----M----oTX--E----|XEoX----E?--?------o--o---XM-|--------M---M-------XM--------E---?EM-B-B-B---X?--?X--M-B--?E-B------X--E---?------X-B--EEM
?XB----Mo------B-----B----?-o--------------o?B--|-E-----?-E-?----X---|B-------|----------o-E---M-B---M----EE|-o---X--M--X---B-----------M---BMM-M------M--E-----o-XME-----MB-----------?BE-M------M---M|
?ME---------?---------o------Eo----X--M-M---M--M|-B-M------E?X---B-EB|-?X----XXE--B---X--------?-----E------XETM------T?M--------ET-------?--?--o-----BB--E--E----E------M------E??-X--B?M?-E-B----oXB-?
EM----XXBME--o----------X-B-B-------------E-----X---oE--?Xo-BM--?---E|B-B?o--B-----X---M--MB--X-X-oB---?-E-M?oX---o--o|-----X---EEXoE---oX--M-E-------?E-EM-o-------?---o?--EM-B--E--E----Bo-B--------Ev
?----?---B-T-MBo--o---M--B---E-------?M--------TE-----------------X--X?-?B---M----?---E-M---E----?-?-o-M-?TT------B-X-|---X-----------M--B----oo?---X---o---B-----o--?-----MB-X----?----XX--o-M-EM-Bo-?-
X-M?----EB-X-----M-B----?-M-X?----X-E----E---E-|--MoM--?-----XB?------------o------oo--XTo-E---BME?---X--B||--o------oXo---?B-E-------o---MB-X--BoB---?--E--M---o----o--Mo--E-----?-?--T-BB---Mo-------|
T?--X----o--B?X-?M------E-E----XX----oMB---o-EXX------?-E?---Boo--------E?----?oM---B---|-?-----------E-X-XX--E-M---------BMo------------M?EM-M--E-----EEE-M?----E-E---X-------XM-M--XBX--------M-M----T
--------B---M-BT---?B--M---oT----X-?B?-B----------MT-B---M-X--T-o---X--X-?B---------B-X-X-?--BXT-----B-o------?---?-T-----B---T-?------X-BM----E-MXX-X---------X-?-E-TE--XE----?--?--B--------X-M-o----?
o?-----X-------|------o--T--|------T---------T-----|-M-?------|o------T------B-----?B-----M---MXT----------E--------|---o-----|-------M--------------?-------E------X|---E-------X--MT--?-----M--------|
?T?----B-------|?-------T|--|--B--E|---------|-----|---------o|----T--|-TMB-E------T---T-----M--|-----T--T-T-------T|---------|X-T-----M---E-------?--T----o----T--?-|--M-----T------|-T---T-------T---B
m|-----T------T|-----T--||--|-----T|--------T|-----|--T-------|----|--|T|-----T----|T--|--T-----|--T--|--|-|-------||---------|--|-------T----T-------|---------|--TT|T-------|-TT---|-|---|---T---|--TM
XXXXXXXXXXXXXXXXXXXXXXXXXXXXXXXXXXXXXXXXXXXXXXXXXXXXXXXXXXXXXXXXXXXXXXXXXXXXXXXXXXXXXXXXXXXXXXXXXXXXXXXXXXXXXXXXXXXXXXXXXXXXXXXXXXXXXXXXXXXXXXXXXXXXXXXXXXXXXXXXXXXXXXXXXXXXXXXXXXXXXXXXXXXXXXXXXXXXXXXX
