-----------------------------------------------------------------------E----------------o-------?------------------------------------o--------X---------------B---------------------B-------------------
------------------------------------------------------------------------------------------------------E---------------------o-?--------------------------------------------o-X--------E-----------------
------o----------------------------------------------------M-------------------------------------------------------------------------------------------------------------B------------------------XB----
--------------E----------------------------------------o----------B------E---------------------------o----------?--------------------------------------EE-----------------E-----------------------------
------E-X-X---------------------------?-----?-------------------------------------------------------------------------------o--------------------------------------------------------------?---M--------
---------------o------------------------------------------------------------------------------------------------------B?-------------------------------------------T------------------------------------
--------------------X------------------M----M-------------------------------------------------X---------------------E-----------------------?-------E--------?-----X------------------------------------
------------B----------------------------------------------------------------------------------------M-------------------X----------------------------------------B-----------------------------------Xv
--------------------------------------------------------------------------------------------------------------------------XB------------B------------------------------------------o-------------------f
-------------------o-?------------------------------------------------------E---------------------------------------------------------------------------------?--------------------E-------------------f
--------M------E---------------------------------B------M---------------------------------------B------------------------------------------------------------------------------------------------------f
----------------o---------B-----------------------------------------------------------------------------------------------------------?-------------T--------------M-----------------------------------f
------------------------M-------E--------E--B--------------------T-------------B----------------------------------------?B-----T-----X---?----------|--------------------------------------------------f
-----------------------------------------------------------------X--------------------------------------------------E----------|--------------------|----X------------------o--------------------------f
m-X------X-------X-X-------X-M--------------B------X---X-XX--------------E---XX----EX-X--B--X-X------X--X------------X-------E-X-------------X-X----X-----X---------M------X----X--X-X-X---?-X--X------f
XXXXXXXXXXXXXXXXXXXXXXXXXXXXXXXXXXXXXXXXXXXXXXXXXXXXXXXXXXXXXXXXXXXXXXXXXXXXXXXXXXXXXXXXXXXXXXXXXXXXXXXXXXXXXXXXXXXXXXXXXXXXXXXXXXXXXXXXXXXXXXXXXXXXXXXXXXXXXXXXXXXXXXXXXXXXXXXXXXXXXXXXXXXXXXXXXXXXXXXX
