------------------M-----oX-------------------------------------------------------------------?--o-------------------------X-------------------------------------------------------------------------X---
-----------------------------X------------------------------X------------------------------------------------------------B----------------------------------------------------------E---o---------------
--------------------------XBM--------------------?-----------M--------E----------------------MX------?-----------------------------X--------------------------------------------------------------------
--------------------------------------------------M---------------T-----------M--------------------B-------X-------------------------------------------------------------------------------?---E--------
---------------------?---------------------------------------?----|---------?-----------------------------E----------------------------------E--------------------------------B----------------------X--
-B----------------------------------------------------------------|-----o------------------------------------------------------?---------------------?------------------------XX------------------------
---------?-------------------------------------------------------XX-----------------------E-------------------------------------------X---------------------------B-----E---------------------------X---
---------------------o--X----------------------oX-------------------B-----o-----E----------M----------------------B-----M----------------------------X-------------------------------------------------v
-------B----------------------------------o-------------------------------------------------M?-------------------------------o-----------------------------------?---------------?---------------------f
----------------?--?------------------XE-----------------------------B--E----------------------------------------------o----X----------------------------E---------------------------------B-----------f
----------------------------------------------M------------------B-----------------------------------------------------------------o---------------------B---------------B-----------------------------f
-----E--------------------X-E-----------------------------------?----X-----------------------------------------------------------------------------------o---------------------------------------------f
--------------------B----------------T----------------------------E-M----------------------------------------------------------M------------------------------------B----------------------------------f
---------------------------------B---|--------M-------------T----------------------T-------------------o-------------------------------------------------------------------B-----------------------X---f
m-------------B----------------------X?E---------M----------XB------X-------X------X----X------------------------XX--------------X--------X--X----------X-----------X-X-----X--?-B-X-E--------EXBX--X--f
XXXXXXXXXXXXXXXXXXXXXXXXXXXXXXXXXXXXXXXXXXXXXXXXXXXXXXXXXXXXXXXXXXXXXXXXXXXXXXXXXXXXXXXXXXXXXXXXXXXXXXXXXXXXXXXXXXXXXXXXXXXXXXXXXXXXXXXXXXXXXXXXXXXXXXXXXXXXXXXXXXXXXXXXXXXXXXXXXXXXXXXXXXXXXXXXXXXXXXXX
