----?-------------------------------------------------X---M------------------------------------------------o-----E-------M-----------X------------------------------o-----------------------------------
--------------------o-----------X---------------------------------M-?--M-----------X------------X-?-----------------E-----------------------------------------X-----------------------------------------
--------B--------------------------------------------------------o-------------------------------------------E--X-E-----------E------------------------------?--------------------o---------------E-----
--------------------------B-------------------------------------------------------------------------------------X----------------------------------o----------------------------------------------------
----------------------------------------------------------------------------------------------M-o----------------------------------------o------------------------------B---X---------------------------
-----------------------------------------X--------E-------------------------------------M----------------B----------------------------------------o-----------------------------------------------------
---------------------------o-------------B---?----E---------------------------------------E----------------B-X-X--------------MB---------B--------------------E------o-B--------------------------------
--------------------B------E-------------E?-----------------------------------------------------------------E----?--------------------------------------B----------------------------------------------v
---------------------------------------------------------------------B---------E--------?---------------------------------------------------------------------------------------------M----------------f
---------------T--------B--X------------------------M-----------------------------------------------------------------X---------------------------------------EX-?---------?------?--------------------f
---------------|---------o-o----?---B------E--------------------o--------------------------------------------------------------M--------------T--------------------------------------------------------f
---------------|------------M---------------------------------?----------------------------E--------------------------------------------------|----------------------------------------o-------------X-f
---------------|-------------------------------------------------------------------------------------------------o--------------M-------------|--------?-----?--------------M-----------XM---------E---f
------E--------X------------------?-----------------------------------------------------------------------------------------------------------|-----B---B-----------------------------?----T-----------f
m----?---------MX-X--X--------o--------------X-X------X-----------------?----------X------XX----o-------X--M--X--------------X---X---X-X-X----X----X--X-----------------XX-----------XE-E-XX----X-X----f
XXXXXXXXXXXXXXXXXXXXXXXXXXXXXXXXXXXXXXXXXXXXXXXXXXXXXXXXXXXXXXXXXXXXXXXXXXXXXXXXXXXXXXXXXXXXXXXXXXXXXXXXXXXXXXXXXXXXXXXXXXXXXXXXXXXXXXXXXXXXXXXXXXXXXXXXXXXXXXXXXXXXXXXXXXXXXXXXXXXXXXXXXXXXXXXXXXXXXXXX
