-?---------o-------E---------------?-----o--o--------------?ME-----BB-----------------------------XM-----------------------------------------o-B--------------------------------------------BX----?-----
--------------E-o--------------E------------------M----------------?---------------------------------------------?--------------------------------------?X----------------------------------------------
----------------------------------------------E----------------------------------------------?--------------------------------------------------------------------------XE-----M------?-----------------
--------------B-------------------------------------o-------------------------------------------------------------------------------------T--------------------------------o----------------------------
----M----------------------------------------B-------------------??----------------------------------------B-----------------------------E|o--------------------------------------------------------X---
------------------------XX---------------------------------?-----------------------------------------------------------?-----B------------|--------------------X----------------------------------------
-----------------M---------------B------------X-------------------------------E------B------------o-------------------------------B-------|---------E----------o---------?---------------------------X--
---------------------o-------E-----------------------------------------o--------------------------------------------------X-M-------------X----------------------------------------E-------------------v
----------------------------------------------?---------------?------------------------------------M-----o--?------------o----------------E-------------------------------o----------------------------f
---------E---M------------------------------------------------------------------------B------------?-E---------------o-----------------------------B---------------------------B-----------------------f
----?--------------------------M-----------------------------M----M------------------------------------M----------------------------------------------------------------------------------------E------f
--------------------------------------B-------M--------B-----------------------------------------o-----------E-----?--B---------?---------------------------------------------------------E--------T---f
------------------M------M----------------------------B--E----------------------------------------------------oo----M------------E-------------------------------------------B---------------------X---f
----------------o------------E--------X-----?-----------X-----------------E---------------T-------------------------------T----------------------------------------------------------------------------f
m----------XX-----X----X-------B-X----------------X--X---EX-------X----------XX-----------X---------oX-----------X--?-B--XX------------o-----------------------XM------XX--------X----X---X--X-------X-X
XXXXXXXXXXXXXXXXXXXXXXXXXXXXXXXXXXXXXXXXXXXXXXXXXXXXXXXXXXXXXXXXXXXXXXXXXXXXXXXXXXXXXXXXXXXXXXXXXXXXXXXXXXXXXXXXXXXXXXXXXXXXXXXXXXXXXXXXXXXXXXXXXXXXXXXXXXXXXXXXXXXXXXXXXXXXXXXXXXXXXXXXXXXXXXXXXXXXXXXX
