|---X?BB??--EXoToo-X-o-E---X----Mo-oB---BEXM?EMEo--?-MB--X---ooM-?Eo--M------MoEXXB?-oB-------Xo?M--Mo?---Xo-B---o-MXB-BBoEM-M-XB?X--?--MEE-B-Bo----XBBMEX--X-oBo--Xo-E?-M-MoM--o-Eo?----XBX-B-MXEMM-o--
?XE--E--XMo-BBB|?M---o--o--?XM--M--BEEM-------Eo--EX---M-E?X-Mo-E--EooM-?X----X--M-M---E-X?-XM--?-BMM-X-X----?-XBEE--T--oMXEEX?-------Mo--B----EEX---Xo?-?BM?-EMo-B-o-E-------?--M?--B-oo-M--o--M--B-X-T
M-M---M----E-MM|--MT---?-X-E--o---EEo-?BX------?------M---EEM--B----XBB-XMMM-EBXo------M-M---XEo--E--Mo--?--o-M---Mo-|ME-------Mo----EXX--o------?-o---E-XXEX---o-MMX--B--?X-X--MMB-Xo?--?--?E-------MMX
XX---o--?B----B|---|---X---E-BE-X-----ET--X---o?-B----MM?E?B-----XB---------M--M-----MM---M--MEB---?-M-E?----?-o--M--|?EBo--o-o?--M--E-oX---M----M--B-B----B--E-?M--E--o?-------X---E-?--X---o-?-MME---T
M-----XB------oXB--X?---?---B------X-X-XM--M---?XM----E---o--o-E-M-E-----E--o-oB--E--o--------E-----E-----X----------X----o-----E--M-MMB---M?E-M---E--M------B-B--E-M-----X--B--MB-?-o-B-oE----Eo--M--M|
--B----M--M--------E------?---E------?---M?---X?-----B-E-B-----o----E--MT---EM-Mo------BXM-----?--B-o--?X--B---o---?-----M-T-E-X-?EE-B-?-o------o---XX----------?--------o--E---?Eo-----------?-T-Mo---T
T-----?E--o-E---E---X--o-----T?-o----------o-----T-B--M--EB-----B---T---|?B--?-----X--M-E-M-o----?------M-X?---B-----X-?-E-|-BMM-B---o?-X-BE-M--ME---E----M?------B-----Boo---------X--X--?-M---|X-M-M--
?o--?o?-B-E----o--oo--oE---XEX-------B-X-BB-MB-BE|---o?---o-oo------X--X|--E-E-o--o---------B-TM-T--To--ooo-----------o----|--B--M--?-----M-B---o-?---o--------B-B--X--?-o-?--------BE--?---?M--X------v
M------Moo-E-E---------o--BB--o-T-?--------------X----M------T--o----EXo|-----?---M-----X-----|?-|--|Bo------E---------o---|?-----T---BX--EX----------M-E--B--------------ooM-----E-------X-B-o---EB-BMT
--B?------?---X--o-Xoo---B--TXE-|------M-B-M--Bo---E-E-----M?X-M-----o--XB-X-?M--o-----?B-X-o-|M-Xo-X--M-MB--??--MoX-----E-X-E--E-|----o--E?-M---X-------M--?X---Xo---X----------B-----BT----oE-------oX
E-------M---M--X----o-M-B--BT-B-X----?---E---M---BE-----?oEo-o-o------M----------T-T--B-------|M-o------?---B---MB-----?---M-o----X-X---B-EE----------o------B----E---E-------EoM-E-----|o----?E--XMB---
o----M-------M-o-?-----MTT--X--o-M-----X--M--?MEoT------------------o----o---B---X-XX---------X-----MT-?-----E---?o---o-T---B--------ToM-?---?---?--E--?TB---M----T----M--T-oM----o--EM-XMM-EM-?oXM-?--E
o--------o-XT-X----BT---||---------M---EE-----E--|-------TB-------o-E--B-T-M-----ET---o---X----------|-----o--------o-BT|--Eo-----?-o|---B------X-----B-|-E-------|-XM--T-|------------T-------o--T--T-o
|-T--T--T---|-------|---||-E--------------------B|---T---|--X------------|--?---T-|-----E----TT--X-o-|-----TTE----M----||---------TT-|------T---T---T--T|-----?---|----X|-|------?TM--B|E---TT-?--|--|-T
m-|-T|T-|---|--T----|---||-----------T---------T-|-T-|---|------T---T-T--|------|-|----------||--T---|--T--||T---------||---T-----||-|-T----|--T|---|-T||---------|-----|-|T------|-T--|--T-||----|-T|-M
XXXXXXXXXXXXXXXXXXXXXXXXXXXXXXXXXXXXXXXXXXXXXXXXXXXXXXXXXXXXXXXXXXXXXXXXXXXXXXXXXXXXXXXXXXXXXXXXXXXXXXXXXXXXXXXXXXXXXXXXXXXXXXXXXXXXXXXXXXXXXXXXXXXXXXXXXXXXXXXXXXXXXXXXXXXXXXXXXXXXXXXXXXXXXXXXXXXXXXXX
