-E-B-Eo-B-?M?M-BE-B-BXXMBMM-?-?---M--X-E----XE?Eo-ME---o-oM--BM--?--M---B-?E-o?o?-E-oo-oX-oXXXME-EB-M-------M-o--E-B-EoX-o-E--M-M-?-oX---E-E-E-XM??B--B?-ooEMMMMBo-EB-E-?-E-?BMEM-MEo-o?oM--EBo--E-?----
-M----?-oo-BXo-B-X--E---o----XB?---XEX?o---E-B--o-MBM-B---X--EB-oXE?-E-B-o?-MoE?-E-E?-o-----MMBEEoX-?----M-E-B-E-E?-E--B-XoBM--M?B?-EM-o-EB-E-?-MM--E-?-oMMo-?M--XX?oM-X---?-?-EEE--XBXo--B-X?------XT--
---o--o-o---X-o-----B--M---X--?-EM-To--?-X----o--Bo?MB?--X-?M--MXM-X-X--o-o?-------o-?M---?B-o-E-M-XM-EBBM-EBEX--?X-M-X?-X--X-?-?XE--o-o--B----B-E----E---MBM--?----------X-M--X--o----oM-o?Mo--o?---|--
-?------X--E------M--XB--BX?B-X--oo|---?-X-MT------E--oEM?-E-----X---Mo-?--BoE------MBXXE-B--E---M--EBB----M-B-EB-XoXE---o-o----M---E-XoXM--------?o-o----------oo---------E-E-?MM----B-M---M---M--XX|--
---?Bo-------ME-X---X-E----B-M----M|-EE-EoXMX-------M---?-XMM?EXE--?E-----oo----MT-B--o??-BX--X-E--M?E--o-----o--E----??-EBE--E--ME-E----EB?------B---M-------??------o--?--B---?-------?---M---o-M--|--
-B-----T-----E?M---XM-------B---?--|-M--T-BB------------E----o?B-M----M-oXM--E??-XB--X-??---E-----M-B-MM--X--X-oo?------M--E-------X?E-oX-??-----Eo--BM-o---M?-?------Mo-B??o-B--B-B--X--B----E-B-B--X--
----M-X|-B-----?oo--B---X--oM-E??--X---E|X-?-B--o---B--BoM-----o-o-EB-E--M?--?--o----o--------E---E---M??-B-?-----------?XX-o------------o?------B---E?-?M?E-----X?-X-Bo-Bo-?---B-XEoX--X----X--oM-M----
--X-oB?Xoo-EoMo---X-MM-----M--?--B----MoX----?-E-M---M--E-o--M--XM-o--E---E---?o--o-?o---XET--o--BT---B----M---------?XE--B-M--?oE??--X-o---o---ME------B-B?----EEo--M-----B----o---??-?----?-B-B--B-MMv
--B------------?--E-?--XM?X-?-B--BMEXM--o-E--T-------TM--XE-?--o-o-M?--E-E--XB---?oXo-E-MM-XE---o-|-Xo-o---E--E----------B-BB----M-E-BE-?--M?B-----?--B-BM-------E-oTB-EM---?EE---------X-X---B-TB-B-?-f
----B----E-o------?-BoX-EB--?---E---M-Mo--?Mo|-X-T?XBX-oXo---XEo-----EX-oE-------B-o--M-M-----B-o-|--E---M---?---ME?XB-X--B--?------------------MB-o---MM-BoEMo-----|----ToBB--M-??X-o--MX---?--X-M-M--f
---ME-oE---E-o-o?-------o-M--B--XX-?--M-M---?X--X|--BEEB-XX-E--Mo------o-EB--BB?--?M-----EE--E--B-|?-?XXX----E?-B---------E---E---------T-oE-B---B--B--------Eo---E-|o--XX--M--?-EBo-M-oo-oo---E-X--EE-f
---B--M-?M-------X-----XE-Mo-M----M--E--Bo--?---EX--o--B----EM--oBoT-X----BBo--B-?---ME---B---?-E-Xo--o-MXB-----M-E-E---BX----E?ooXX?M--XoM--E-M-MM-B--?o-oEo--oB---X-?--?-Bo-o-X-----M-E-MXX-o-MEB----f
----------BBEX----XXoM---EEM-E----E--M-?-E--oM-M--X-B------?-o--E-EX---B----o---o-BE?----?M-B--XE--B--------------------B--Eo--?-----?--?----oB---B---X--M?---M---oXM?-M-M----??-?-E-----?-E----MBEMB--f
---??-----E-B-X--Bo-------B-X?------MB--M-----E?o--M-o-M-E----------Bo-Eoo-M-X--M---?--------------M-BE-----MB---B--------E-B--M---?---?--E-XEMXBM-T--BX-M---------M--X-----??-?M------M--X--B--M?E----f
mo--oXE?oXM-ME?-XB-?X---BoB?-M-?-EoX?--o--X--MM-oX-MEo?--MM--MBE--EMB?BM--o?-E--B--oMBBEM---M?XE-E-o-?oE--B?E----oo?X--?B--?oM--XoB--?-oEEo-E--EB-BXoXM-XEo-X?oMEX-EE-BX?-X----BEooM--oo?-ME-BEoME?-oX-f
XXXXXXXXXXXXXXXXXXXXXXXXXXXXXXXXXXXXXXXXXXXXXXXXXXXXXXXXXXXXXXXXXXXXXXXXXXXXXXXXXXXXXXXXXXXXXXXXXXXXXXXXXXXXXXXXXXXXXXXXXXXXXXXXXXXXXXXXXXXXXXXXXXXXXXXXXXXXXXXXXXXXXXXXXXXXXXXXXXXXXXXXXXXXXXXXXXXXXXXX
