----------------------------------------------------o------?-----------o----X--------------------B------------------------------X---------M-----------------------------X---------------------M---------
-----------------o----------------------B---------------------------M----?---------------------------?--------------------------------------o------------?-------------X--------------------------------
-----------------------------------B-X---------------------------------o----XX--------------------------------------------------------------------------------------------------------------------------
-----------------------------------------------------------------------------------M--------B-----E-------B----X-----------------------------------------------?-------o------o-------X------------B----
-----------------XX--------------------------------E-B-----------------------------------------B---------------o--------o----------------B--------E-----------------------------------------------------
-----E-----X--------?---------M--o-------------------o----------------------------------------E-----------------------------------------------M---X-------------------Xo--o-X---------------------------
---------------------------------X------------------------------------X----XB----M---------------------------B------------X----o---------?---------o---------XX--------------E---------------------XX---
------------------------E------------M------M----E-M--------------?---X---------------------------------------------------------------------------X------------------------------X---------------------v
--------------------------o-------------X---------------------BX----M--o----X--?------------------------------------------?----------------------------------------------------------------------------f
----------?-------MX-----M--B--------------------------------------------------------------------------------?--------------------E-----------?-----------o-X--------------------------?------X------X-f
--------------------M----E-----------------------------------------X?-----------------------------o-------------------X---------E----------------------------Xo---------------------BX---?---B-X-------f
-T------------------------------------M-----T--------------------------X--------------------T-----X-----------------------M-----------------------T------------------------E-------------------------T-f
-|----------------------?-------------------|-----------T-----------------------------------|------T----------T-----------------------------------|---------o-------------------------------TB-------|-f
-|------------------------------------------|----B------|----------------T------?M----------|B-----|----------|-T--------------T------------------|-------?-o-T----------------E------------|------TX|-f
m|-------------------------------T----------|T----T-----|T---------------|---------------T--|------|----------|-|--------------|-----T-------TT---|-----------|--T----------T------T-----T--|------|-|-f
XXXXXXXXXXXXXXXXXXXXXXXXXXXXXXXXXXXXXXXXXXXXXXXXXXXXXXXXXXXXXXXXXXXXXXXXXXXXXXXXXXXXXXXXXXXXXXXXXXXXXXXXXXXXXXXXXXXXXXXXXXXXXXXXXXXXXXXXXXXXXXXXXXXXXXXXXXXXXXXXXXXXXXXXXXXXXXXXXXXXXXXXXXXXXXXXXXXXXXXX
