--E----X-X---?-----------------------------------E-----o--------------------------------B-----------?--------------------X-------------------M------------M---B-----------------E-----------------------
----?-------------------X--------------------------------------------------------------------M-----------------M------------------------------------------------------B--o---------------------------M--
------------X--------------------------------------------------------------------------------M---------------------------------------XX----o-----------------B-------?----------------------------------
-----------B---------------------X-----------------------------------------------X-----------------------------------------------XX-----------------------------------------o-------------B-------------
------------E--------------------------?--------------------E--------------------o----------------------------X--------------B---------------------------------------------------?----------------------
-----------------X------------------------------------------------------------------------------------------?--M-----------------------------------o----------------------B--------B--------------------
---------------------------------------o-------------------------------------X-----------------B------------o-------X---------------------------------------------------------------------E-------------
--------------------X-----------------------------------------------------------------------------------------------------------------------------------------------------------B----------------------v
-------------------B-----B-------------------------?-----------------------------------X---M------E---X-------------------------------------------------------------------------------------------X----f
-------------------------E--------------------------------------M----------------------------------oE--B-------------------------------------------------------------X-----------------------------X---f
-----?----M----------X------------------------X------EE----X-----------------------------------------------------E-------------------------------------------------------------------------------------f
----------B----------------------------------------B-----------------E-----------------------B-------------------------------------------------E-------------------------------------------------------f
---E-T------------------?-------------------------------------E------------------?----------------------o----------------------------------------?-----------------------B-----------------------------f
-----|--------------------------------------------------X------------------------------------------o----------------------M----------------------?-----------------------B---------------------------X-f
m--X-X------X----X----------X----------------X-----M---X--?X------------X---X------X--XX--------BX--------BE---------------B---o----X--X--X--X---------?------------X----------X-M--X------o---X---B---f
XXXXXXXXXXXXXXXXXXXXXXXXXXXXXXXXXXXXXXXXXXXXXXXXXXXXXXXXXXXXXXXXXXXXXXXXXXXXXXXXXXXXXXXXXXXXXXXXXXXXXXXXXXXXXXXXXXXXXXXXXXXXXXXXXXXXXXXXXXXXXXXXXXXXXXXXXXXXXXXXXXXXXXXXXXXXXXXXXXXXXXXXXXXXXXXXXXXXXXXX
