MB-XXoXE-oB-??X?-oBM-XM---?-?-XXoE-Mo-E?EXXB-XB?E-X-XE---oMEo-o?-MMoM----MXMo-B--?MXE-B-?XM-?M--?E?-M?MXM--EX--o-EoM-ME-X--X?EME-EM-EEXX-EM?EXE-MX?B--BXEX-X-Mo-EB-BX-ME-X-?BXM-oM--o-X-----B-BB?o-oo-XM
|--?BE-M-B-BB--E-?M-E----?-?-MB-E-E-EB---B-??--??-X-o-o?--M----B-X?-?X---E-----M-M--M---TE-o-E-XXoo-M?---BM--MoE-?ME--o--M--------oBM?-E??E-o?BoM-E--MBXB?Xo?B-ME--?-E--X--oEo---B---XE-B?--BoX--o---E-T
o-BoXBB??-X-o----EoMoE----EEX?--oB-MMEX-E--M--ME--E----?-E?--E?Mo-B?-X--E-E-X----X-BMM-?|-----X-XE---M-E-?---o-MX-TEo-BBM?------XB?-?--B--?T--MoMB-?--oEo------MB--?o-?M-----E-EMEo?-B-EoEX-oX?-----M--X
o-------?------E--MEB-----B---ME?-----------M--X-?--X--Bo---EM--M--M---X---?-----ETME-?M|----o--E?-MTM-oB-E-T--??M|----M-E---BB----o?--oX-E|---MoE-B---X--M?ooX---XX-E-XB-o--B-B-?-B----M-----?--?-EE--o
o------?o-----Xo-o----E?--Mo-o--Mo--?--TM--oMM--T?-------X----------o-o-X-M-oXo---|-----XX------B---X--o-B--X---E-XBBXM----------E----Bo--?|-----ET----o-?-----oXE----B-M?--?--M------X-------------MT-|
T------E--M--?--X--E-----------B---Eo--X-M-----B|?------X??------o?X--------------|?----B--E---?--X-BBE-oE-------E-E---E-?-----------B-----|---?--XBMM-E-----M---o-----oo----B--B--MM-----oB------E--X--
X-o-XM-EM-B--------o-----X-o--------------oX-?--|?E--EM---BoM-E----E?-----X--X-o-B|------E-B-----?-oE-Eo-------?----BMo------X-?--B--o--M--X--X---B-M-----X?--B-X---XE---MXMEo--?-----T----M-X-------o-X
M-o-oT--o-----MX--o-oX-X-B-B------o------------TX-?Moo-?---------B-?-E---?-E---MMMX?------E----EXoB------Eo-------E-o--E----------MoX---B--B---B--??-o---------X------X-X--B-BE-?-EBX-XX---o---M?------v
?X--?X-X?o-o---BX-------B---B-M---B--o??X------|--?o-E-?XB-X-------------?-M-B-BM-----E--E-----o-M-oT-M----o---X----Mo-----M--?Bo-------oB--B-MMM-E---B--o----M-----M-M----T-o--o-----B--ooMT-?--oMB--XX
o---E-----B---------o-----B--B-?----XB----BM-?B|E--------EM--o------M----B--?---ME---XE------B-----o|--X----Xo---M-T--E-X-M-oB-----E---B--BM-X----o-Mo-X-o----B--------T---|B?----?----E----X---X----M-o
T--?-----o-Eo?M---EM--?--E-M-E--o----E-B-Mo---B|------B-X---o-X-----?-E-oo-X-?----E---E--X--M----EM-X-----B--?-M---X--o----B-o-?-?-ME-?--XE----E--o-E-X?X-X-T----Eo----X-M-X----E??-----??--?---BB-EM-M?
B---M----T--o----B-----TXEB--M-X-M---B--?-----MX------M-BT---------MM-----------M-----B---?-----o-?--B------Bo-----------Too---M--T-ME----o--E-------?-T-o--X---?E--EB-M--ToM-------?-MB---E-M---------T
B--------|--E------B---|-o---B--o--------T--?---M--Xo-ME-|E---MEB-M--o-?MM---------------B----E---E-E----o-X-----------B-|--E--o--|------o--XB---X-----|---B---XT-XB--B---|-To-T----E-E-T-E---------o-BE
TB-------|-----?T--T---|--T-M-----?--o---|T------B-------|--------To--B-------------E--M------BT--------E----------------|--------|---E--T--T--E-T-X---|X-------|-----T---|-|-M|-o------|-T--T---oTB----
mT-------|------|--|--T|--|------TT------||--T----------T|TT------|------T-------T---TT-------T|---T------------T--------|-----T-T|T-----|--|--T-|-----|--------|-----|T--|-|--|--------|-|--|----|-----
XXXXXXXXXXXXXXXXXXXXXXXXXXXXXXXXXXXXXXXXXXXXXXXXXXXXXXXXXXXXXXXXXXXXXXXXXXXXXXXXXXXXXXXXXXXXXXXXXXXXXXXXXXXXXXXXXXXXXXXXXXXXXXXXXXXXXXXXXXXXXXXXXXXXXXXXXXXXXXXXXXXXXXXXXXXXXXXXXXXXXXXXXXXXXXXXXXXXXXXX
