--------------------------E-M------M-----------------E--X-----------------------X----------X------------------------------------------------------------------------------------------------------------
-----------------------------------------------------------------------------------------------E----------------------------o------------------------------M-----------------X-------------------B-oXX--
-----------------------------------------------------------------------E----------------------------------------------------------?-----------------------B----------------------E----------------------
-----------------------------?------M----------------------------------------------------------------------------------------B------E-----M--------?-----------------------------E-----------------X----
-------------X------------------X------------------------------------------------------------------------E-----o-----B------M---------------------------M------------M-----------------X----------------
----------------------------------M?------------------B--------------?---------------------M----X-----------M------------------------------------------------------------------------o------------------
---M---------M----?-----E?--------B-----M--------------o----------X---------------M--------------------------o---------Mo----B--------------------?X-B--------------------------------------------------
----------------------------------M------------M-----------------------------------B---M--------------------------------------------------------------------M---------?--B--X--------------------------v
-----M------------?-------------------------o---------B-----------------------E---------------------------X-------------------------M-----X--------------------X------------------------B--------------f
----------------------------------M---------------------------X---o---------------o-----------E----------------X--------?-------------------------------------------EXB--o----------B-----XX-B-----B---f
---X?------E-----?M--------------------B-----X---------------------------------------------E-------------X---------------B------------------------------------------------o-------------X--------------f
--------------------------------------------------------------------M------------B-----------E-------------------------------------------------------?-----------------M-?-----------------------------f
---------------------E--------B---------------------------T-------------X-X------------------------------------------T-----T---------------------------?-----------------------?-----------------------f
-B--------B---------E-----------------------o-------------|----E---o---------------M---------T-----------------------|-----|--------------------o----T----------------------------------B--------------f
m-------T-------------------------T------------------T----|--T------------T--T---------------|----T--T---------------|-----|-------------------------|---------T----------------------T--T--------------
XXXXXXXXXXXXXXXXXXXXXXXXXXXXXXXXXXXXXXXXXXXXXXXXXXXXXXXXXXXXXXXXXXXXXXXXXXXXXXXXXXXXXXXXXXXXXXXXXXXXXXXXXXXXXXXXXXXXXXXXXXXXXXXXXXXXXXXXXXXXXXXXXXXXXXXXXXXXXXXXXXXXXXXXXXXXXXXXXXXXXXXXXXXXXXXXXXXXXXXX
