----------------X-----------BXM---M---------------?E--------------oE-----?--------------------------------X----------------E-----------X?-----------------E-X-------------------------------------------
------------?----E---------------------------------?----?o------------------------------------------------------B--------E-----------------------------M----------------------------------------XX------
------M-----------------------E---------------------------------------------------------------------------?--X?---------MM------------B-----------------------------------------------------------------
-------------------------------------------------------------------------B-----------------?-------------------------------------------------------------XE---------------------------------------------
----------------------------------------------B-M---?X--------------------------------------X----------------------X--------------------------------?------------------MX-o------M----------------------
-------------------------------------B----------------------------B------------------------------------------------------------------------------------------------o------------------------------------
-----------------------B-------------------------B---o---B---------------B-------------------B--------X-----E--------------B--------?--B-------------------------------------B--------------------------
---?------------------B------------------------------M---------?--E---------------?-X------------------------XM------------------------------?--------------?----------------------------------------?-v
-------------------------------------------?-----E--------------------------M----------------------------------------------------------M-----------------------X---------------E--------------------X--f
--------------------------------------------------------------o-----------------X-------------------------------------------------------------------------------------------E-----B----X-------B-------f
----------------------------------------------------------------------------------------------E-------------------------------------------B----B-------------------T-----B-----------------------------f
-----------------E-------------------B--------------------------------------------------------------------?T------B----------------------E-----?------B-T----------XX-T--------?------------------M--X-f
-------------------M-----------------------X-----------------------------------------------------------T---|--------------------------------------------|-------------|--------------------------------f
--E------------------T---------------T----------------------------------M--o----M----------------------|---|--------------------------------------------|-------------|--------------------------------f
m-T------------T-----|---------------|----------------T----T---------------------------T--T------------|---|------------------------T-----------------T-|-------T-----|-----------T------------------T-f
XXXXXXXXXXXXXXXXXXXXXXXXXXXXXXXXXXXXXXXXXXXXXXXXXXXXXXXXXXXXXXXXXXXXXXXXXXXXXXXXXXXXXXXXXXXXXXXXXXXXXXXXXXXXXXXXXXXXXXXXXXXXXXXXXXXXXXXXXXXXXXXXXXXXXXXXXXXXXXXXXXXXXXXXXXXXXXXXXXXXXXXXXXXXXXXXXXXXXXXX
