?---Xo-oBo--------MXMoX?oBM---MX?EMB-BMXEX?X-?--B--B?-M?-oE-BX?o-?-?M?o-o-EM-M?B--o-B-BB-oB-EB----E--EMBMM---?-oE---BX--X?MMo?XoMM----?-M-?-EME---X---E-E-?M--E--BXoMoX--?-?MXoo-?B---o-M-M-?-M--E----?T
EXBXMEE---MX-oB--B?E?--oT?BX-M-X-Xo---BE-??--B-X-XM-?-MX---?---M--XB?---X?o-X?-o--Moo-B---E---E-EMX-XMEXE-EXME-oE--?-?X?-----EXM-o-MXE--?XBE-Mo--o?-o-X---E---E--?oM-B?M-XB-oMXB---XBXX-BMM?B?--EM--EXEM
E--E---o---M--?M----XM--|--o--BX---M---MEoo-M--o--E--B-XoE---o--EB-Xo-M--BE-E??M-EM---o?-?X---E--E------E-M-EoMM-----B--o-----EE--?X?M?MX?--Xo------XEXooM-B---T-E-o-Eo-?-B-XX---B?--EE--E-MEM--M---MoXB
BXM------o---X-B?------?|-M----o-----oX-o?----E-B---o--M---X--M-?BB-M-----o-------?T---B--------?------oB------M?---E-o-----B?-BB--oE-------E-EM------o-M-M----|--Bo-?--EXoE-------------E-----o----X--?
o-------oB-E-----X-M--M-|-EEo-X---T--M----?-----B-o-?E-----------E----o--?B-B---?--T--?-?--MT-----Xo?-------B-B----?--------EE---B--M-oX--X----E---X-E--oM-o---|X--------o-------X-?-----?---XB?--o-?XTM
--?BB-T---X--B-BX-Bo-X--X--------B|-B---M-o-M--T--M--o-B--X-o--XX-E----ET--E-------|--BX----|M---B-M---B--X------M-??--X--Xoo-?--E-M--?-M--TM?-o--?--------?EE-X--B--E-o---?B--Eo?---B-E-E--?---------X?
M-oMEMXB-X------E--E---X----M?-X--T-----M-E----X-X-MME-----B--B?-o-X-X-?X----EE--B-|---?E--BX----------o---E--BMX--M-------------B---------Xo?--E?M--?-T-X----E--oMo-EE?X-----M-?M----M---o----------?-B
XX------------oM------------?--E--|X--------B-XEE------TX------E--Bo-EX--?---E--?oo|--B---?---MM---M----X-XT---?-MX----M-X-X------BMM--X-?----XoB--X--T|----X-------E----------M---?----B------?-BXE-M-v
X?E--M----?-X---M---o--M--XM-----T|----M-E-o--T?-BB----X----MM------BB---oB-?--MB-MX-X-BX----X----BBXM-BB--T---B-B?---??o---------o----B-T--o--B-o?E--|XB--o--E-o-X-E---M-M-o---?X-MM----X----E-ET-o--X|
E-----?-Eo-?---B--?--E---oo-MB---|X-?-----M---|-B-----o----o-BE--?----oX------?-?-------?-o-B-M-B-B----B-ME|ET?--M--X---E?ME-?--o-M------X--M---------X--E-M-------?-B-X-?M-o------------EM--o-X-XE--B-o
X----??--M-o--M-------o----X---M-X-----B--MBM?|-oB---MM-?----o-M-B--M-----o--?-ME--MB-X------B-M----E--Bo--|-X-ME-?-B-B----E-M---------EB?-------oMo-B-B--EB-o-B-M-oo---M-BX---Eoo-o--o----?--o-M-EX-B-M
--TX----BE-T----------T---E----E---T----?-EB--|o---------E----E----------X-------?-B?X----M--BE------------T--------MM---oT--BX-T------o--X-?-B-Xo--M-----------?oET----T-B--E-----E??-----B--E-------oE
?-|---BM---|-------?-?|---?---X--ET|-------M--X------T-B-?--T--?--------oB---XB-?----M---------?-----------|E-----EX-E----|----T|----X----o--B--T--?---MBB----T----|----|-----o------------M------M--T-X
T-|--------|----T-----|--T--------||-----------------|--B---|-------X--T----TTT--?------T----T--?-----TB-oT|-----T-MB-T---|B--o||---To-?---T----|-----X------T|----|-oT-|o--T---T-----------------T--|-X
m-|--------|----|-----|--|--------||--T--------------|-----T|---T--T---|-T--|||---------|----|--------|T--||--T--|----|-T-|---T||---|--T---|--TT|--T---------||----|--|-|--T|---|-----------------|--|-E
XXXXXXXXXXXXXXXXXXXXXXXXXXXXXXXXXXXXXXXXXXXXXXXXXXXXXXXXXXXXXXXXXXXXXXXXXXXXXXXXXXXXXXXXXXXXXXXXXXXXXXXXXXXXXXXXXXXXXXXXXXXXXXXXXXXXXXXXXXXXXXXXXXXXXXXXXXXXXXXXXXXXXXXXXXXXXXXXXXXXXXXXXXXXXXXXXXXXXXXX
