|X?E----oMX-X-BMB-BXBoM?oB-BB---M-BME?-?B-o-MEB--E--o--?Xoo--?E-?M--M-E?-X?----BoE-?-M---XBBBB---XBo--o?-EoXoXBE-Eo-E?--BMo??-EXMMoBMBM-M--BM?B-oM?-oBX-M-MXo---B-Mo--MBBoBB-XEM--MXE-M-BB-M---E?XM-EX-M
oB-BX?MM--XE--BoB?----XM-E-?B-Mo?-?-o-o-E-E-?-M--?XBE-XT-Bo-X---E---X-XXM?---o---B?-X--?--BM----E-?--E-----M-X?BM---E-EX-oB?-o-X-o-XB-M-B-MBME----EoMM-M--o-?oB---oMEM---oo--EBB-B-EMB--oMoXX?-X-EEM--MX
-X---o--?oEX?-XMoX-??--XX--M--EM-M-X-o-XB-XB-?B--X--?-o|XBB-oMB-B--oB----X----E-B---o-oo-?---E----B-T-MX-oB--o?M-X-?E----EXXM-B-E--M--BM---MMX--Xo?MX----X?---EE-X-?o-MBo--E-E-M?---?-ME--BMB------E-X??
M-BEX--------o?--BEM---XoM-?---o?--o-------?--------?E-|-EMM----M------M----EB-oo---EMX-M----EX----M|--?M-------B--TE-ME--E-o-o-----X---Mo-------E-o-B--------X-E-?---BoE-----X??--ME?--?-X-BBo-M----?--
M--M-o--E-----MX---?-----MX?MB---X--B-----o---EM---M--BXB-Eo--T----XM---X--B--B-MBM--M-------B----X-X----Bo-?----MB|B---X--B-----------M?------E-----------------M-X?----X-------X---B-M-T---oM--X--EE-|
X-M-----E--M--o-o----E-M-------XE-E---X-X-------M---------oo--XM---?---XB--E--Bo---X-MM-EoETE---M----M?------------X--??----X----M--??---E--XM----?o---BM-TX?-----X--------ooBB-?--XE-MM-X---B--??------
XE-E----M-----------M-X--X--BoM?--M-------?-T--X------BBE-BE?E--B---X-M--------E--?--o-o-T-|---E--o--?oT-o-B-----M----??------M-EE?-??BX?-------X-M---o---|-----E--M-----E---E---o---M----E-M-?MEB-----T
|M-TM-----------X?E---EMXM-o--E-?-----T-----X-X-?-----E---E-----E?--?--oTo----E-X-B------|E|---o---BM-?|-E-T----M-MMXEB-----MME------?------E------Bo-----XXB----?E-EXTM-o-----E--X----M-----B---E---B-v
o?EX-EX------o-XB?-XTE--oEo--o?--oB---|T--Bo?-B---oEX-B------?X----B--?-|--?----E--------|-|--B----E-X-|X-?|M-X-E-?--MB-XX---B---------X--B?----o----M--B----------M--|----M?o--?------M----o---------BT
M----ME--?o?X------MXME?o--XE----?--o-XXEo---M-?--?E-T--BX-EXE?--TB---E-X---M-M-M--------X-XBM--------B|---|-?----E-?-Bo-M------------B-?-oB-----------X-----X--E-----|--E---------BTB-E---X-B??------?-
T-E-?-Mo--E----E----B??-o-BE----Mo--E?--MEXB-M-o-----X?-M----B---|---------Mo----B--------B-M----M-X---To--|-?-E--------?B--XBBEX----M--------E------M?EXM----E-------|---TM--------XM---EoB-E---X-E---E
E-B--X----?----------M-Eo-E?--E----T-T----M-?-B--To-----------B--T-T-?------M------MT---M-----MX-----EBX---T-M----?--EB---------M---------M--o-----T-------E-------T-EX---X-EM?---E--?EE--B-X----M-M---B
?-MT-B------M--------------------M-|-|--M-B------T---------------|-|--------T?---B--|E---o-------E-----B---|M--------E------E--T-------TX----M-?-X-|---o------B-T?-|-EMB---XM---o-M----------T---------B
E-E|----E------E-T-------------T---X-|-X---TT----|----M---------T|-|--------|-------|-XT-------To----------|--B-T----T-----M---|-------|T--M-------|---T--------|--|---------T---------------|-----o---?
m--|-------------|----T--TT----|---T-|----T||-T--|----T---T--T--||-|--------|-------|T-|-------|-----------|--T-|----|---------|----T--||--T--T----|---|--------|--|----T----|T-TT----------T|---------|
XXXXXXXXXXXXXXXXXXXXXXXXXXXXXXXXXXXXXXXXXXXXXXXXXXXXXXXXXXXXXXXXXXXXXXXXXXXXXXXXXXXXXXXXXXXXXXXXXXXXXXXXXXXXXXXXXXXXXXXXXXXXXXXXXXXXXXXXXXXXXXXXXXXXXXXXXXXXXXXXXXXXXXXXXXXXXXXXXXXXXXXXXXXXXXXXXXXXXXXX
