-oMMBB-?MM??EE-?o--o----?oM?--B?MB-XBMXMM-oXoE-MXBBXEME?BBo-?-?-BBM--?MB-E--M?---B-M--MB?EM-o----B--EBE??-BE?ooX-B-Eo-oXB----?-o---Mo-E-BEM---?oX-EoXMoo---o-?B--M-XBBoEM?-EMoEMoBXXE-M--E--MMXM-XM-??--
-oX-?--BE-?-X---MBMME-?-X--E-M-?-B--EB-M?-B---X--E-B-XB?-----oBMBXB-X-MM--M---XBX-EB---M--?-B-BX-X?BXM-B-E-E-E-?XXXo--X-oM---M?B-BEo--o-MB?-?--oo-E------M-B-MM-E--Eoo--X-ooXM-XB---X-E--?-oE--oX?---ME-
-BooM-----B?-EE?XEBo-?M--?Bo---BE?-??---MoB-BMXMB-XMo?-X--o?-XXM--o--M-??oM--oEM---X?-o---B-o-E--EX-XBBX?-MX-M-EXE-?-o-?--EoX-o-?-?BB-oE--X---BX-E-MMEBEMM---M-oo-M-o-X--Eo---?ME-?--E--EMX?M--ooo-oBo--
-?M?MMMo--EM----XE-o--Xo--XMM?-EX-B-??MX--o?M--o?M---X----E-B--oEXB---M---?XE-Xo??-X-E-XMEoM-E?---o---oM-MEXo?-XME--E???---M---M-oMM-?E-XE-BB-M-EEoM-M?MXo-EB-?XXXBM?-XE-M-E-MX-oMoo?XXEE--M-EE??X?-BoB-
--E?MM?-X-??--X-X-BMX-EoBXEXB-?E---o-MBEooo--E??--MEo-BoXo-MXBEBB----??M-?MXEo?X-oX--EE-----BXEoB-X-o?MEXMBBXMB---Eo---B--B---XMMX-X---oEB-XMXo-oX-X-?X--B-MEXE-MoEBXBoMBE-----B-M---o-?-B---?oM-E--X-o-
--EM--B--EB?-?--?MXXE--EX-o?----o-B-E-?B?X--oo-B---o-?M-X-?---?--MXBoE-MEEXM??-EBBEM-X-o-o-EB--M-XMM-o-M-EE?-o----??Mo--X-M-oEBoo-BBEo-B-?MoMoBXEo?MoX-Mo--MEEM-B?-E-XE?o-?-BX?oX-X--XBBo-X-B-o-XEX?E-M-
-X?X-B?E?-M-Eo------X--MEEBX-o-BBX?M-MoBE-E--BMo?XM-oX----B-------MBMo--?oo-BM----oX?-M--EEM-MEM--E?E--ME?-??B-o--M?--B---EXX-?oEMo-oEXBMMXM--??M?oE---?--??--Xo-X-Eo--E??X?-XX-X---M----?----oEEB-X----
-E-MB---MX?M-?--EXMB------B---BMMX--XMo-?--?X-oB------B-oXo-oBBoMoMX--EEo-o-XM-E-o-Xo---M--oX-EX?-M-o-X-?-B--Bo??--E-oM?XXMoE--EM?E?--BBE--M--MBoo--o?EMXM-?EoBooE?MM-?ME?-EMM-EB----BXEM-M-oM-M?o-oMo-v
-oB---MX--X-EMEo-??-oMo?o--XMB-X?B?-MEMBB--BEo-B?MooMBMo-?oB--o-oo?MBBX--oE--MB-BB-MXME?--oX-----?BE?B-ME---XE-MME----BMX-EMM-??E?-XEBM--BE---o-M?B-?XBM--XE-?EM--X--?--?XBoB?E?M-?EoXE--oX---XXBo??-o-f
-MX-E-M-EME-E-XXE-?-M----MoooXoo--B--M-MXB-----oMB--?--X-M-Xo-BM?X--M-EBo-o-?E-oE-XMo-oo--E--MMM-?-??BEX?--BM?X?o-oBX?oo-M?B-EM-X----oX-ooX-o?---E-EMo-XBX-E--BoX?--EXoB---MBXE--X-XEEE-M-B----EEXBX-E-f
--E-X---E----E-B--X-X--oX-oMBMMo-X---BoXM-Eo-B-----EX--M---B?-BB-?BoE--E?MMXX-BBX-oXoMEE--?Eo?EX---B-o-?--EMo-?X---Eo??o?-?XMX?-?BBEEB-EBX-B-B---E--?oX-XMX--M-?BooMo-XBM-MMMo-X----o-X?M-B-EXEEE---BM-f
-EM?XMo-MEM?---XM--?oE-BM--?o?-E-Xo?BM-M-BM--?--BX?XEE-XoM-EXE-XBX--E?-M-EEE?Mo---?-?----o--BB---B-M?-E---XXM?MXB?B-?--o-B-EMXE-BBXoB-XE?XM--B-M---X-o-E?M-XEB?---E-Xo??ME---X----XM-E-B-M--o?oBEB--BX-f
-Mo-?-M?Bo?BXBB?-MM--X--B?--o--X?M-EBMM--?-MooM-BE-M???XB--?M?-EEoM-EE??-BM-?-oM--ME?B--X--o--M?XE?-M-X------EE-?--M-o-o--MBXM-B-B----BMo--MX-BE?oMX--M-X--XBo?-Xoo--B-Eo---?B-?BE--EBBXE----M-o---MMEof
-o-o-BX-MEo-XooB---?MXXEXX--B-XEo-?M-E-oE-M-X-Mo-o--EXX-XE-B--MoM-?-X?MM----XE?M-o----o?--M--EEBoEEM-?X?-Eo-E-Xo-BB-oEXo-o?BX-oEXEEEEEM---o--XE-X--E----o----EBo---B-?-BX-??EM-?--oX-o-X?-BM-B?oM?XX-Bof
m-?-?XM??------M?---oE----M--o-?BE?M-E?-XB-E--XXXo-BX--EMM-MXEBo-BEXoo?--?-?MoB-XB-oBoX-M-E-?-?-?E-o-BX-BE--E-E--?-?MBX?-XE--BoB?---B--o-?-oMX-EBMBBBXMMXM?o-MEMM--o---XEMEo?-?X-BBoE?E-X?---MM--M?E--XX
XXXXXXXXXXXXXXXXXXXXXXXXXXXXXXXXXXXXXXXXXXXXXXXXXXXXXXXXXXXXXXXXXXXXXXXXXXXXXXXXXXXXXXXXXXXXXXXXXXXXXXXXXXXXXXXXXXXXXXXXXXXXXXXXXXXXXXXXXXXXXXXXXXXXXXXXXXXXXXXXXXXXXXXXXXXXXXXXXXXXXXXXXXXXXXXXXXXXXXXX
