XEB-----B---Eo---oMBBMoXMo---X?E?XXo--BX?-oX-X?-?oE--oE--MoEoXE-----?-X-oXMM-oEBoBMXBE-oX--o?BBX----E-?E-?X-----MEMB-----E---X---XXo?BoE----B-oM?XE--Xo-XoMB?-X?M-EoEXB?X-oo--o--?E?--o---?MEoX?E-MX??-?
o--?---ooXMEB-MXBoM?-----MM?-BBo?ME-?-X-B-oM?-----XBM-M-?-?X----EMMEEXX-E?--?--Xo-BoX--???-?MX-o--XoM----M-M-EM-MX----BoMMX-oE-E---BX--oBo-X-EX-B-?--?-X---B--Bo----E--BM-E?EEB-M-B?M--X---M---XBB--oEoE
?--BM-oXo----X--XM-oX-EoEEM?X--M-EM-oo--BX--oXoB?-o?-o-?--o?-XM-EMBM-BMMo?--MB---o-X--XM-oXME---o-E-X-EM---M---X?EEoM---E?MoX-B-XEo?o?Eo--?BoM--o-M-o---B---E-Eo-?--o--E-o--oo-o-E?X--?-BBB-XoEM-E-X--?X
-MB??XBBE-XM-?-o-?--oXXE--B?-B-B--o--B-E---E-E------Bo-M-B--B-oE?MEo-Bo-BEBM?M??B--oEXB?EX-oXXEM--EoMXM--BE-MEoEXM?-o?-XXB--o?o--X-B-M--?X-BBEEoE-----BooM?MX--XB----X---MooX--Mo--MM--?--E-MBEBXE?oX?X?
M??-??-oXX-?X-?--B-E-BooM---M---Mo?X--XBo?-B-?X--XM-EE-----oMM--XEM?-ME-EM-?-oooB-----Bo-MB-o-?-E--M-M?oEB-E-X-?o-o-BBBXX-----XEMBX-?-Mo??--o?B---MM-oE---EEEB?B-X-MXB---E-Mo??--BoEoM-BXME-?--MoBM?X-BX
B??--oMBMM-EXX-?--?M-M?XMBMEo-EoX------o--B-BoEBBBo??-XBBX-?-B--BM?-Mo?M-o?B-?--oEXoMX---E--BE-----oBX-BX-X?BM-E--M?MB--XEE?MB?o-o---?B?BE?--?--oEE--E--X--XBBBE---B-EX--MXXMX-E----Xo-BoB-MBX-??-E--?-|
T-?--EM?--o-EMM---X?-XM-o-X-Eo?-B--M-?BM-X-?o--oMXE---MMXBBM?oMX-MMBo-ME?E-?XXM-M?-o-EE-?oX-o-o-EE----o-B-EXB--E--oB---??-BX---o--B?X--M--XX?-X?oM?ME-X-?M-M?X-?BBBMooE--o?-oBBM-E?oB-BB-X-o??--X-o??-MB
oM-B-B-E-oo??oo?E?Eo--XEB-?oMMB-ooMo-Eo--EMBXE-Bo-E---E?-MoE?-E-?---?EXE??--E?-XMo----oM---M-M?XMEo--E---X-o??-o-B------ooE-XM-o-oM-o---MM--?o--MB?-E-M?-?X-E--Eo-?BM-MBXXEM-o-Mo--XX?B-o-B-MBo-E-E-X-Xv
E-X-?X-XB--?oB-EBoX-XEBBX--o?X-Xo-XBoMo-M----BM?-B-XMEoo?-o--B?-?B-MXX--o-X-EBoB?-oBBoBE---ME-EB--X?-XoMMB?MMo---?BoMoEX-Mo?--M?B----o-o-BX?--?-?-o-M-B-XE-E-o--?X-oXEX?-?-EX?EBB?M-?oE-M-?---E-MB?--MX-
T-EE---B??M-oBB---oX--X-?-EE?B-oEXXBXoE---MMEX-oM-?---B-M---XM-B-E?ME-M---?BX-EBEEXoMB-MM--M---o--?oM-EEMBEBX-EEXM-o-o?---?-M?B-M-MX-MX-B----o-?-oBoME-B-?-EM?E-?M?XEXBX?-BX--?o-ME-B-o-M--oBMEX-M-o-o-|
|-?EX--?MM-?Mo--o-M-BX?X--Bo?oEX--B---M?ooX--??-?-----oMB-B-M-MMB-oo----oBMMXM?---E------o?oXBM--MEoM-BM-MB-M-E-X-B-M--??-X-oXM-XB-?--XMM-?E--oE-M-?X--BB-B--B-?BE-B--oXM-EoMEMo-M-??MXE-oEMX-EB-E-?-M-E
Boo?---?oE-M--E--?-----XME-X-o?----o-MXM-E-o--E?E-X-BMB--M---MX?o--o---BB--XM-BXE-o--?--BX-?X-o-Xo-MMEX--M?-o?o?oM?-B-?-MBX--BoBXEMX-EX-E--MEMEoEXBBE--E-MM-EMoMB--BBBBE--Mo---B--BM---MMMEBE-oE?o--B?oE
oX?oEXXXMoXoBMB-XMo?-?XMBE?--Mo---E-X??B-X-M-M-?B-MX--B-E?XB---?--MMBEo-?---?-o?M--M?-BoXXBX?EBXBB--Mo-oXo?-?-XXBEo-oE?-B-oBMo--M--EBB-X-XMB--?E-X-BX?X-BoE--MMo-oEooXo--?EBX--X-EoBX-?----MM-o---M-?M-B
?EM-??E-XBM-?-oM--Eo-B-BBB---E---BBXo?oo-XM--?M-oB-?-oXM--B-E---X-Xo--EEM--oE-?MBM-Xo?-XEX-BoMM-o-XoX?-o--B??BMX--B?-X-XoM--oB?---o--o--B--M---B?---X--oM-?M--M-?-EE--oXXooMMoM--X-XEMX-E-MM-o--Mo-----o
moM-?BEM-?E?--------XB--?-E-E--EoM-B??oEME-oX-BMBoE-X--?MoX-M-oMXMBBMM-M----X-M?----BM?-?o-o-XM--o-BB--XX--BX---B?XME-B--M-o-B-EB-EEM-M-?-M--MX-----o--EEBX?MM--Xo-BBBB-oE--Moo-?MXMMM--o?oB--X--M-X-X-B
XXXXXXXXXXXXXXXXXXXXXXXXXXXXXXXXXXXXXXXXXXXXXXXXXXXXXXXXXXXXXXXXXXXXXXXXXXXXXXXXXXXXXXXXXXXXXXXXXXXXXXXXXXXXXXXXXXXXXXXXXXXXXXXXXXXXXXXXXXXXXXXXXXXXXXXXXXXXXXXXXXXXXXXXXXXXXXXXXXXXXXXXXXXXXXXXXXXXXXXX
