------------------------------?----------------------------------X--------------------------------------------o----------------------X------------------------M-------M------------------------X--------
-------------o----------------------------------Xo-------o----------------------------------------X---------------------------------------------------X----------------------------------------B---X----
------------------------------o--------------------------E--------------------B-----------------------o----T---------------------------M----------------------------?X----B------------------------X----
-----------------------------------------------------------M-----------------------------------------------|---------------------------------o--------------------------------------X-------------------
------------------------X------------------------------------------------------X---------------------------|--B-------------------------------------B--o------B--------------------X--------------------
---------o-------------B-X----o-----------------------------------------?-------------------M-------------oX---------?-------------oB---------X---------------------------------o----------------?------
-----------------------------------------------------------------------------------------------------B---------------------------?---------------------------M------------------------------------------
-------------------------------------------------------------------------------------------------------------------M-----------------E-------o-----------------------------------X---------------------v
----------------X----------------------M--------------------XX----------------------------------------B-------------------------------------------------E-------------------------------------------X--f
---------o--------------------------M----------?----------M--------X----------------------------------------------------?-M-----X---------X------------------------------------------------------------f
-----------------BX----------------------------------------------------X---------------------------------------------------------o?B-------B-------------------------------------?-------X-------------f
---------------------------M------------------------------------------E-----------------------------------------E---------------------------------?-----------------------------------------------X----f
----------E-----------------------------------------------------------------------------B---------B-------------------------------------------T--------------------------------------------------------f
--------------X-----------------------?----------------------------X---------------------o----------------------------------B-E---B-----X-----|--------T--B----------------------------------?---------f
m---o--X-----X-----------------------X----------------?--------?--X---------X-------------X----XXX---------------------X-----------X-X--------X-----X--X----X----------------B--X---------------X------f
XXXXXXXXXXXXXXXXXXXXXXXXXXXXXXXXXXXXXXXXXXXXXXXXXXXXXXXXXXXXXXXXXXXXXXXXXXXXXXXXXXXXXXXXXXXXXXXXXXXXXXXXXXXXXXXXXXXXXXXXXXXXXXXXXXXXXXXXXXXXXXXXXXXXXXXXXXXXXXXXXXXXXXXXXXXXXXXXXXXXXXXXXXXXXXXXXXXXXXXX
