--o--------------------------o------------------------------------------------------------------------------------------------------------?------?-----------------o------------M---o---------o------X--
--------?--------------------------BM--------------------------------------------------o----------------------------------------------------oX---------------------------------------E---------o--------
--?------------B-------------------------------o----X-----------------------------------------------------------------------------------------------------------------------o---------------------------
-------MX----------------------------------------------o--------------------------------------------------------------------------------------------o-------------------------B-------------------------
-o--------------------MBo---------------B---------------?---------------o--------------------------------------------------------------------o----------------------------------M-----------------------
--o--M--------------------------------------------------------XX---------------------------------------------------X-------------------------------E--------M-------o------------------------------X----
---------------------------------M-----------X--------------------------------------------B----------------------------------------X--------E---------------X?-----oX-------------MXX-------------------
---------------------------------M-----------E---------------------------B---------?------------B-------------------------------------------MX-----X------------------------------o--------------------v
-------------------------------MX------------------------o---?------------------------------------------?---------------?--------o---------------BE------------X--X--------------------------------o---f
-------------B----X------------------------M---X------------------------------------------------------?-------------------------M------B-B-------------------------------------X---------------B-------f
-EM-------------------------------------------B---------------------------------------E-----M----------------------------------o--------------B------XX----------------?-X----E-----B------------------f
-----T---------o----EEX----------------XE?----------------------------------B--------------------------------------------B-?---------M---------------------------------T--------------T----------------T
-----|-T----------------E------BX-----------T---------------------------T--------T-----------?-----B-T----T------------------------------------------------------------|--------------|-------------T--|
-?---|-|----------------T--T-------T--------|-----E---------------------|--------|-------------------|----|--------------------o----------------T----------------------|--------------|-------------|X-|
m----|-|----------------|--|-------|-------T|---------------------------|--------|-------------------|----|-----------------TT------------------|---T------T-----------|---------T----|----T---T----|--|
XXXXXXXXXXXXXXXXXXXXXXXXXXXXXXXXXXXXXXXXXXXXXXXXXXXXXXXXXXXXXXXXXXXXXXXXXXXXXXXXXXXXXXXXXXXXXXXXXXXXXXXXXXXXXXXXXXXXXXXXXXXXXXXXXXXXXXXXXXXXXXXXXXXXXXXXXXXXXXXXXXXXXXXXXXXXXXXXXXXXXXXXXXXXXXXXXXXXXXXX
