----oB---oBE-oMEXXoE-XXM--X---oXXM--?---M?XXo--XE---M-o--EoBB----o--B?-X----oX-oXEXXXE--o??ooEB--X-BX-EX?BoM-o-o?o-B-E-MEE?Bo-XEEo-oB---?-BEX-X-?-Boo?B?-B-Eoo-MM--Bo--M---?XE-MB-EoBE--B-?---B--E-M?M--
--X--E--B--M-B-?EBXB?X-X--EEEB-EB-----oE-B---BoE-B----XE-?--B----M-E--?EEB--MXo---BEo---oo?-X---B-oo?BX?E-XMX--M-Xo?M?---EX--E--oEMXB---o?--oMXEEEo--BBoB-B--EXE---E-oM?--M---X-XMMXEo------X--E---M-?--
--E--M---?B----oBo-B?ME---B-?B-?XM--EMoEB-M?MEEEM-M?-?-oM---M-Mo?MB-B--?M--BE-?--?EEBMX-o--M-?-o-MMB?oMo--EE----oB---??--M--MMXBo-o?-oX--MEXBEo-o-M---oE-Xoo---B-M---M-Mo--o-----XoEXXoMXMo-X---B?M-?X--
----M--?--------------M---X-M----ME-----o--E----o--?X?------?-X---XB-----------------------EM?-?-EM--E-??-EE--B--M--EX--E--B-X?E??-?------?B?----o-------E------B--B---o---E-E----B---------E-?------?--
---------------?MMXM----??B-EM---?--X----E--M---?------M?o-?E-M-B-----X------B-T---M-EX-EE--B----E----E--E-oMB------E--M-EMM-----B-----B-?EBE-B-E-?-?--------?--M-----M?--M---M-?---o-------o-B-X?B?B---
---?EM--T-M---BE-------B--MM------B-Bo----B--------?-o----B---M--B--M-M?M?o?M-T|-----M--M------oB-o-XEo-----Mo--X-M-----B---------o-M------Bo-EM---o--?o-MM---M----M--BB-oo-XoM?--X--BB--EM--X---B-o----
--------|-MBX--B-o----M-----Xo------o-BB-B-BE---------------?--M---Xo--------E|XMBE?B------?-------------M---oB--o---X----M-------?---EX-----E----??-E----M-TX----?B----XB?-?Bo--MT-??-----?--MX-?------
-XME-E--|E?-------B----B-o---o-o---------M-M-ME----B-----MB-----B-?E--oo?---E-X---M------MM---B-B-E-?-----B-o--M-----?oX-E---M-?-M----o---?-T--M----M---oE-----?---?---------B?-o-X--?-M-MBoM--------?Bv
--?-E---|B--BM-B-----------o-?--------o----EM-----M-EB--EE-X----BXM--?E----E---o-o---XX--?-?------T---oB?X-B-M--MX---------MM-B--M---BE--oB-X--M-X--EM-MMB?-XBo-?XM--?-----o-M--E--XMo---MM---oE-------f
-E?----XX-----B?-BMX--X--o?---M------B--oo---M-X-BEo--E-E-E----E---------?----M----ME--o-----EMXMo|XMB------?----BE-----Xo------X-----------?---M--?-oM---?-B-?---B-?o-E-M-?-----?X?o?------M---B-M--?-f
--------E-o-----o---M--oX----B--EMBoX---Eo-M---B----?B-M-B-o-X-M?-E-------EXMo?-o--B--o--oEo--B---|--?--XE-E-----o--MMB----XM---B---?-MX---E-MX-M-M---M------?------????-------ME----T---E-o-Bo----X---f
--oo--EX--E-?B-BMo----E------------B---------o-B---EM?------oMo-?M?--M--X?--EoBXM--E--------o-M---|-?-----Mo-M-------?-?----------B-B?---oX---MoM---o---o-X---?-B--E?--E------o--oE--|X-----?---X--E---f
--------M-?-----Bo--?-------?----o-o-oX----E---oo----ME-o--B--E-B-EX-M-EB-------EX--?--?-E---?M---XB---E--M----B---o-B-M?-MMMB--------XX------?---Bo--?-M-??---o?Xo--?-?E-E---M-B-B-B|---X---X-E----o--f
-M-o-ET-BX-?Eoo---------?--?-E---B-E-----------o----B-o-------M-B--M--To-oX?--------EE-----XB----M---B--B--MM-------M-?----------oXB-------B----?--M-XM----------M-X------------?---E|BoB-X--E--MXooBM-f
mEEE--X-?EXM-EB---X-oXE-M-XB-oM-X?-MB-MB-Eo-Eo----X-BXM--X-B-XXXE---o-XEM---X-XXM----o?oooBB-M--X-o----M-MEB-E-M-----?o-o--E?M-o--B?X??--E---XE-B--M--EE-?MoEM-B?B??-E?X--X-M-X-EXB--XM----?--?Xo----M-f
XXXXXXXXXXXXXXXXXXXXXXXXXXXXXXXXXXXXXXXXXXXXXXXXXXXXXXXXXXXXXXXXXXXXXXXXXXXXXXXXXXXXXXXXXXXXXXXXXXXXXXXXXXXXXXXXXXXXXXXXXXXXXXXXXXXXXXXXXXXXXXXXXXXXXXXXXXXXXXXXXXXXXXXXXXXXXXXXXXXXXXXXXXXXXXXXXXXXXXXX
