?-MBMoB-BE-X---XM?B--?-MXM--?M-MME-B-??-BEB?B---EBXEMM--BEBM--B-?---o-M-XM?ME-?M-Mo-MM-X-XM-?o-?-o--o-X-MXB-M-X-oX-oo--E-?X?--Moo??BM-E-XXE---MBX-B-B?---E-B---EMM-M----o--o-Xoo-M?----oo-M-?XBM-X-?-MMB
|Eo??BM-XX-o--B---oEX-ooB-X-M-MMX--MB?X-BXMME----B?oEX-o----Xo-X-E--oBX-----M-oMoM?X-E?EE?---?ME?oE--MB-M--?oMM----XB?E-Eo-E-X---E--XB-oo?o-o-M?-E-?BE-BB-XX-EE?-EX-X-E-?BBMEo--BMXX--B-B-----X--?M--o-B
|Xo-B-MB-o-o--?-E---oEMMBMBo---oXB--BX--Xo-E?BT--B?EM---XMXBB-E----X??----X?-XEME-?XTX-M?Xo--M------MM---XX?o?-Eo?o--B-EE-oXo-E--EX-EoB-o--o--MBEM---X-oBE-E--oo--?---oX?------E-Eo--XE?-X?-B-----X--M-M
|-X---?-oT-?--E--oo?-?M-T-B-MB----?--?--------|-o--o?XMX---E--o-oB--o-------E-EXE-B-|-XX----M--XE-------------XX-o--o---B-----TM---XXM--BM----------MXoB--M-X-BXXMo---EoXBM?---MB--X-E--?----o-----o-?--
o--------|-MB----E-----BXB?M--Xo--T-------o??-XM?-X------EM-------X---B--E----?B-X--X---?MB--?-E-?o?-----?T?-M----MoT----?---X|---?-E-Bo?---?B-----------To---Mo----oo--Bo-o----E--BM--M--M------B?-E--E
X--------X--E?M-X---Bo----o------E|----EM-M-----------------M-E-o----E-X-o-X?-o---X--BB-o--------B--------|---M----B|X--------|XM--E-MM-o-X-----B------X-|-----EMo-X------X-XE--?--??---------E--Mo--M-o
-E-T-------X-B------?-oM?--B--E?--X--TE--M-X------X---B---B-E--X-X--E-----?-B-E--X-?--BX?--B-------E---Bo-X---------X-E---??-B|-?------B----E??-?M---B--E|M---------EX----M----XM-------M------B------B-
?--|-M------BME----oMo---------X-X--TX-?-E--B?--X-?------------E--E?-o-------M--??-E-----MoEE---B------?-E-----X----E---?E-o-?X---X-?---E----M-oE--------X-B-?----B----X-B-X-E--E--M---o--E-B---E--?E--v
M--|X---BB-ooo?-B-XB---E---?----XoEEX-----o--?------X--Eo------?--------E----------M-----oEE---M-TX-----Bo--X------?o---oB-----T---M------o-o---?B---M-?--------X-B-------o--o-------?B?-----?--BE---X-E
o--|----E-X-M----X-----o-M-E-M--E-B-TE-Eo---EB--B--XoM-o---BM------XX---MM-----E-X-M--Moo--B--TM-|---X---M---?-----------?EX-M-|--X?---E--M-M-M---X--o?E-?--E-----E--E-----------E?-M--MEX--BE---o-M--BM
-M-XB-M-BM-B-E--E---?-M-BMM-M--E----XM-----o----------B?BX?----X--?---?---XX---B---BMB---?--XXX-B|---B-oBE-E-E?M---X--XB--B--B-X--?--E---XBB-E-oX----------o--T?-M-----B-?-X--XM---o-?--E------------o?-
T?E---?E-----?E--T---oo---oET-T-----oT-T-B---?-?--M--------M-BE-EXB------E-E--E-o---?-B--M-----?-|----TB----M-T?--Xo-E---To---EM---T---o--B--M-B-BX--B-MET?E--|TB-?-----X--oB----------MT--B--M---?-B?-o
X---o--BT--------|---M?ETE--|E|-T---o|-|---X-------------------E-?-----MM---o?---oETT-E----o----TX--TT|----B--|-----EEX?-|T--M-B---|-B-B------------BM---|----X|---B-----?--------X-B---|-----M----T-T-X
o-------|E-------|?----T|---|-|-|----|T|-M--X----T---B------?----------T------T---M||---?-------|---|||----T-M|T--------M||TB------|T-----------T--------|--T-E|----T---T-?--X-------TT-|--T----?--|X|-E
m----T--|--------|-----||---|-|-|----|||---------|---T--T----T------T--|------|--TT||------T----|---|||T---|--||---------|||-----T-||-----T-----|----T---|--|--|----|T--|------------||-|-T|-------|-|-M
XXXXXXXXXXXXXXXXXXXXXXXXXXXXXXXXXXXXXXXXXXXXXXXXXXXXXXXXXXXXXXXXXXXXXXXXXXXXXXXXXXXXXXXXXXXXXXXXXXXXXXXXXXXXXXXXXXXXXXXXXXXXXXXXXXXXXXXXXXXXXXXXXXXXXXXXXXXXXXXXXXXXXXXXXXXXXXXXXXXXXXXXXXXXXXXXXXXXXXXX
