-----------------M--B--?-----------M-----------------------------------------------------------------------------------o--------------------E-------------E-------------------------------------E---X---
------------M--------------------B-o----------------------------E---------------------------M------------------------------------XM--------?B-----------------------M-----------------------------------
----------------------------------X------------------------o------------------------------------------------------------------B-------------------X------M----------------------X-----------E------?X---
------------------------------------------B----------------------------------------oM------------------------------------------------------------X?-----------------------------------------------------
--------------------------------------------------------B-----------------------------------------------------------------M-----------------------------------------------X-----------------------------
-----------------------------------------------------------------E--------------------------M-------------------------------------------------------------------------------------------E---------------
---------M----?-----------------------E----?E----E------------------X--------------------------------------------------------------------------o----------------X---------------------------------------
-------------------EX---------------M---------------------------------------------------------------------------------------------------------------E-----------------------X--------------------------v
------?---------M-------------------------------------------------------------------------------?------------------------------------------------E----M---------------------------------------------X--f
------E-------o-----------------------X--o--------------E-------------------------------?---------------?-------------M---o--------------------------------------------------X-------------------------f
----------------B---------------B------------?--------------------------T-------------------------------------B--------------------------------------------------------------------------B-------M-----f
------------------------------------------------------------------T-----|--------------------------------------------------E----------------?--------------------?---------------------------o-----X---f
---------------------?-------------X------------------------------|-----|------------------------------------------------------E-------------------------o--------------------------B------------------f
-------------------------------------------B----------------------|-----|--------------------------------------------------X-------------?--MM--?-----------------------------T------------------------f
m--X-X------------X---X-------------X---X-X----X-----XX-----------X--X--X?---------?-B--X---X-XX---XX---X------X------X---------X----X---------o----X-X-----------------------X------------------M-----f
XXXXXXXXXXXXXXXXXXXXXXXXXXXXXXXXXXXXXXXXXXXXXXXXXXXXXXXXXXXXXXXXXXXXXXXXXXXXXXXXXXXXXXXXXXXXXXXXXXXXXXXXXXXXXXXXXXXXXXXXXXXXXXXXXXXXXXXXXXXXXXXXXXXXXXXXXXXXXXXXXXXXXXXXXXXXXXXXXXXXXXXXXXXXXXXXXXXXXXXX
