T-ooME----oE--?o-Xo?BoXo-EBB--oX-E--EMX-M---B-?-o---E-Bo??B-oE?EoBXB-M-XX--?M-XB?-XEMB--M--MBM-oB---X?-BBE-XB--E-BB-X--oE----o-X-o-X--M?--BEXo--oo?--X--X-MMB----oBM?-?oM?-Eo---oB?--B-?--X-EE--B-X-MEEo
BX--BB--EoMM--E--X?--M-M-EE----?E--o-EMM?-oEE---?XMo----E---?-EM-E-oXX--T--E--M--B--XEBB-TooX-?E--M--o----X-o-?MM--Bo--E-MME--X?-M-MB-E---XEM-oo-EoM?---M-EToX-?M-?-MM--X-BB-?--M-X-----EBo-----?BE--M-B
E-E--E---MB-XB----M-----ooo-XX---BXBB-o-MBBBMoM?E-o--E-T--X-B-?B-B---B--|-o--XX-XX?--MEX-|-X-B-M---------E-B-oMB----E-X?oX--X-B-?M------?--BXE---?M--o-?---|--ooE-M?-B-B---M--MMB--B-B--M-X-o-M--B---o--
T-----?-E--ooX-oXo--Bo--B?------E---o---EX-X?E------B--|ME--------?-E---|-B-M-X---Xo-----|M-?-B--?------M-----XEB-X-B??-XoX-B-M-oo-----EE-----------MM-T---|--E-X---oX-M-----X-o--B---B-o--X-E-----B---E
X------E-X----E-B-X---B--EBoM-E--o-------?----?--E-?-EMXE--E-----ooB---M|--?E--TEM--EE--?|----ME----ME----------o----------M-----o-?-------T?---TM--?--|---|X-o-----?-B-?--M---?--oo-M----BE-EEE-M--X-XB
E----M-----o-?----B-----o------?-----oB---B-EMoo-oM-E---MXo?B-T-B?----E-X-----X|-X-T-B---X-oX-----M----Xo-B---TM-X----B-o--X--MX-B---------|----|-B--M-|---X-----MBXM--M-B-----B-o-----M-M??o--T---T-B-?
E-M---B----E--o--?-?---B--M-o--X-E------B---------o----o-o--X-|-?o?-------M-?EMX--X|M-B------BE?E---M--T------|--??---?--------?-o-B-------X----XX?----|--Bo-----M--BX-M---o-?--oE---?---E----B|XoM|-M?B
o-------o------o?B-X-T--o?-M-E---EB-o---M--M------------oEE-B?|-E--Xo----?------XB-|-?----X---E--BE-B--|B---XX|-oo----B-----?---B-X?----T--------------XB-?X--TXo-------E-B--M-E-oE-B?X---?E-B-|--MX--?v
??-EEE?---E-------M?-|o?---X-?-?oE----X?---EE-EB--X---X?--X---|-----T-?--o-------B-|---?-X--?-TX?-ooEM-|-E----XXBX------E-TMX---XEEXB---|M-?--------BB--M-MB--|E-X--BXXB--oB??--B-----EM--?--X-|?--B--EM
o-?--B---?--E-E---E--X-?----oBB---o------B-B-?o--M-X-E?-B---E?X-MB--|-o-M-M---E-MM-X-B--E-E---|E--X----|--BooM-oE?M--?---M|-?--?X----Mo-XM---M--o---XET-B-B---X----M---X----X---?---B?-o?Bo--oBX--Eo?-?-
--E---X---MMEM--o---Bo-X--XME-X----------M---T?--X-E--oX--E-E-X-o?--X?----X?-E----B--?-----BX-|M-E-o--XX-o??-o-----------M|M--Bo--EE-M-----MoM-B-B-XME|---o-------X---E----X---?X--MB--EEBB-?E--o-BB---E
B-?-T-TT------------B--oo--------T-?X--Mo----T??----E-----??--B-TT---M-T-B---T?o-?-oo------B--X--B------?M--oooE------X---|-To-B---B---E------?-M--E-EX---T---oX--ME---M---E?----X------X-X-?B---------o
E--T|B||-----------X--B--T-------|-----------|---T--?-----M-----||?----|---T-|--------E----E---------------T-------X-----TX-|---------ET----------T-------|T------M-T----------------T---M----EM-------M
---||T||-------T---TT----|------T|-T-----T---|T--|--T---TT------||--T--|---|-|---T----?-----T-----------T--|-------------|--|---------T|----------|--T--TT||---T----|T----------T--T-|T----------T----TB
m--|||||-o-----|---||----|------||-|-----|---||--|--|---||------||--|--|---|-|---|----------|-----------|--|-------------|--|---------||----------|--|--||||---|----||---E------|--|-||----------|----|T
XXXXXXXXXXXXXXXXXXXXXXXXXXXXXXXXXXXXXXXXXXXXXXXXXXXXXXXXXXXXXXXXXXXXXXXXXXXXXXXXXXXXXXXXXXXXXXXXXXXXXXXXXXXXXXXXXXXXXXXXXXXXXXXXXXXXXXXXXXXXXXXXXXXXXXXXXXXXXXXXXXXXXXXXXXXXXXXXXXXXXXXXXXXXXXXXXXXXXXXX
