--M-o--Eo-XXo-EX-M-o--E?---oXBEoB-B---M-MXXo?-B-MX-----EoE-E--oEE--XMM-B-E-oX--E---XoMEB-X-E?BB-B?--E--EXMoo-?----o-M?EB-B--MM?o?-T--ooBMMMX---X---oBBo-BM-oB----?-B--EM-?--E-???-BB-M-Eo---?-------BM--
-X?EBEEEoEBE-BMo--E---B?M--B--E?B-B-EX------M----BE-B-o?------B??-?-E-X---ME-oXX-M?-X-oMXMEXM-M-?---?-B-M-E-?--Bo--B-X---EM---o-E-|MMXB---?Bo-E-E----E--MMo-EXoEXB-X-E----M?To?-E-X-M--M-oEMX-X-?Eo-EMX-
--MMo-?oooE---EBEM--B?--EXB?-E-XEoX?--E?-BBM-----E-?-X-X?B-B-o-E-X-X-B-?-B----E?--o-X-E?XXMXE--?EB---EE--??X?--Xo--XM-BMo---?M--o-|o--oM-Mo-XX--o-oEE-XB-T--?-B?-Eo---o--?X-|M?-EM--M---MX-?-?-??--M----
---?---XB--?-X---Xo-XM--o-E-----B-E-----------X------X-B-?MM---MoB--M------?B-----------BM---BE-B----?--?--X----------?B--?----o-?|?--B-?----X-E---BoEo--|Mo-M---o---?M---B-|---B-X---oX-------B-E------
-----?---o---?----?--------o---B-X-------B----E?--Mo----------E-----?X----oE?--M---X--T----E------?----?--------T--EX----?---?-?-----M-----X--X-------BE-X----------X-?-?-E-|oXX-?EX---o--oo--MoEo------
-B?------E---BEB----X-?-E--------BE-------o---------E?-X------M--XM--------E---E------|X-?----B-----------?---X-|M--o------X?BBoM-X-X--E-----ME-EM---oT-----XX----M---BM-oM-XB----?------E-----o-?---E--
-E----?-E??--?-ME-----M-------B----?-M-?TB-XXE--Eo---MM--E-----?------To--B-E-M----M--|------B---B---X----B--E--X----o---------------?---E-------B---B|--??E-EEM-B-o----E---o-oo----B---?M-E--X--??--o?-
-------E-B----EB-----MMM?-M-oB?X--------|B------------?BE----------o-XX------------M--X-----------M-BM--o----o-------MM---o--------TB--B----?---M-----|B-E---------E-X----M-E-----B---------X-EE--oB-E-v
---?-----B--B---oB----?-----MEE--E--MEB-|-E-----EE-M-MM---XEo--o-----E--E----E--E-T------??--o----B--o--M-ETE---?E---?-Xo----?E----X--o---------BB----|---M--MET?----E-o--?-----oXM-BB----B-o-------B--f
------Bo------M-------M-?-oE---M---B--B-|X-----B-------?--E-----?---oB----X?--?--?XM-B--E-----E--o-?------EX-X--B--M----M-X-----o---B-B-o--B---M---?-XXo-----B-|-?B-X----?-BM?----BMMo?-BEE--X-MM-M-E?Bf
-XEB-B----EXX-oBMXB---?---o----oXoEB----X?---XM-B-------oX-X-X-oMM-----EMB--B?--EM----Mo-?----o-M---o--?-oB-?E---?----ME------X------XB-------X-X-o?X-MBB-T-T--XM----Mo-------E--B------?------E?--E-ETf
----X-M---B---T-?---XT----B----E--B-EB--?o----MM---B-X-B-----MT------B?------o-?T------T--X--T-B----?--?--E----M-M--B?---BEM-E--B?-X-----------?-----E----X-X-----------TTB-M-T-T-X--?-X-B-Bo-----T---Xf
-X------------|------|-------------B--X---T--------B----------|?M-o------B-E---o|---XEX|-----|-B-MTMo-E--T-------E-----T-o-M---M-----TT---------------------BET--B--T-B-X|---M|-X-------------ME--|T--Tf
-------------?|------|------T---TTT---?B--|-----T---B---------|-----TX----T-----|T---B-|T-B--|----|--T?X-|-------------|--------o--E-||--E-T------B-----------|-----|---T|M---|-------TB--T--X-o--X|--|f
m----T-T------|----T-|------|---|||-------|-----|----T--T-T-T-|--T-T|----T|--T--||T----||-T--|----|--|---|T-----T------|T------------||----|------------------|-T---|---||----|-------|T--|--------|--|X
XXXXXXXXXXXXXXXXXXXXXXXXXXXXXXXXXXXXXXXXXXXXXXXXXXXXXXXXXXXXXXXXXXXXXXXXXXXXXXXXXXXXXXXXXXXXXXXXXXXXXXXXXXXXXXXXXXXXXXXXXXXXXXXXXXXXXXXXXXXXXXXXXXXXXXXXXXXXXXXXXXXXXXXXXXXXXXXXXXXXXXXXXXXXXXXXXXXXXXXX
