??-o-B-?EME-?-E-----B-X---XBXXo?-?B-XM-X--ooMBMoM--??oEXB-?-E-MX-B-EE-X?EoEMM--oBM-BBoM--EX-?-X--MBMEX-XX?-??--?MBoB----------o-BEX?Bo-XoBE?-Mo-E?-M---Mo-MBEo--oEBo-ooXE-XX--?--MMB?B--o-B--?o--B-M--oT
?-M--X---BXX--o--o-?-Eo-X-M-?X-BBB-oBX-?BB-EBoX--?-E-E-BM-BE-M-?E-o-?--BMBB-o-?MBXoMM-?-oo-?-MoBo----X-E-B---o--M-MEMX--E---MoMXoME--o--ME?B-X-----o--oo------EE-X?---oMoo?----o?MBX-E-E??M-?-EM-M--o--X
M--MX?MM-BM-XB--?-BB---EEE---oo-B--E-oo-M-o-B??EEB-X?-E-?XE-?TEM-M--XB-----E--X----oM-o-??oBXX--?-ME?oM-MET-EEEB-----MX---EB-E?-B-----M----o-E--EE---oM-E-EM------M-E------o-X---M-?--B--E--EXB--X--X--E
-XM-----E---E---------E-----T--M---T--B---o-X-?-o----M-----E-|E-----X-Xo---B-X-E---EX-E---B--M--X--XB-B---|-M-------------M-oo--XB---MB-----B?-B-BM---?-?----E----M?-ME-M------ME--B----M-BX-B--B--?--?o
X----E---?---XXBE-M--X-M----|---T--|--M----X-------BX-----B-oX--M-X-M----?BoM--M---o---M-M---E--M--------BXE--------MXX--XM----M?--TX----------B-BoB---Bo-B-----BX---MoX--EM-M--M----E-BE---?--E-X-----o
E--M-oBBo--B-EM-------o--B--|-?-X--|-M-------TT----?-o--?-----M--B-E----?---o--M------?-T----o----X---E---Mo?--o--X-----B-oE--B-BE-X---X----o?E-XE--X---B-------------M-?-E-o---?-----E-B------M---X-X-E
|---E---?E----MX-?--M--X---o|-o--M-X-o--X-EoM|X---------M---X---X------?---??--o--M?----|-?---?o---E--E-------oTT?---?-----B-o-?-E--o?B--M---B?-----E---B-MM--E--E--M-----BE-X-?MM-XX-----oX?o-o-XE--?-X
--oB-MX-M-----M--?--?--?--E-X?------?B--o--?M|--?---o--?------B----o--o-E-------E---M---X------EEoE-E---o------XX--TT---MM-?Xo-----B------X-B------B-----?M------o--------M---BB-BE-E-XE------M------o-v
?oE-M--X-?-----------E--B-o----MT-M---E----?----EE-MBX---?--E--M?M-----Eo--------E--E----X---B--------M----BB--M-X-XX------MM?-----B-------B--Bo------E------o---B-TB-o-B--X?EE--o?--M-B-X------?o---MET
-----?--o---X------?-?B----E-?--X--X--BTXX-o-X?-E-----o?-B---M?------?----?o--T--o-T-EB-------B-Bo-BM----X-Mo-?M-EE------?o---?-------X------?E-----TMEM------X--M-|?B-oME-T---o----?ME--------X-?---B-T
---X-----?B-ooX-----B-E--B-------------|-EXB--oBM-oB-B-M----?E?-?------EEE---X|o-?-|-----X?X------o--XT--E--------B-o--Xo----M-----Eo-?--?BE--E--Xo?X---To----B-?--X--o----XEXE---M-o-EEo-?---Mo---M---o
-E---B---------EX---Mo---E----------?-B|-MB------E-------B---TEoBB--M-XM--B--EXT---X?---------?B------Xo---------?B-o--T-----B--E-E---EX?-----------T---X?------B---M-------?-T-X------T-----oB----o---?
M--B----X?---T--M-??---B--------Mo-----|M--T---o--T----o--B-?|E---M--X-oB-?T---|-E-------B---------MX-T---------TTM----|?------?---M-----?-E--B-E---XE-----T------M---------TBX--BBM---|E--T-o?-M-o--X-T
B-------M-E--|----------B-------------TX---XT-----|-----o----X-----------M-|---|-M-------B------------|---------||T----|---T---M-----------T----T------T---|----------T----B|--E-----E-|---|B--?B------T
m----------TT|----------T------T------|--T-T|-----|---T---------------T-T-T|T--|--------T--------T----|T--------|||T---|---|-----TT--------|----|---T--|T-T|--T-T--TT-|T-T-T|------TT--|---|-----------?
XXXXXXXXXXXXXXXXXXXXXXXXXXXXXXXXXXXXXXXXXXXXXXXXXXXXXXXXXXXXXXXXXXXXXXXXXXXXXXXXXXXXXXXXXXXXXXXXXXXXXXXXXXXXXXXXXXXXXXXXXXXXXXXXXXXXXXXXXXXXXXXXXXXXXXXXXXXXXXXXXXXXXXXXXXXXXXXXXXXXXXXXXXXXXXXXXXXXXXXX
