|-X?E-MBXE-B?X-BEM-?-X-B?-EE?B-MBBXB--Booo-M-o-oo----oE--B--?B--o-X?o-X--o-EBE-o-E??--Xoo--X---?-B-o-EM-EEX-M?BE--EEB?-?EBEBXBB---EXoBo--o-?MXMB-EE-BX--B--E--?M-E-B?--B?-?M?-B-ME-oB--B-?--EE-oo-M--E-B
-X-X-B-XX?ME?M--oB--XB-BBoE-E-X--MBBB--oXEM-X--X-o-?-XX--oBo-M-?-o-M--XM---M------?BEM-??o---X-XXBB-E?-BB-M-BMMEE---E---EBXBX-oBE---Mo-M-BX---?T-EX-MEo--o-M-EXoM?---XoX--?X?----ME-M----E--M-oBB--M---X
|--BMo--E---MX------X-M-?-X-oo--M-M--B?X?o---M-E--B---?ooE---BXX??-EB-X----oBB--B---EBE?Mo-o-----BoEXX---M----?-M-E-E-?X--T-M-XoE?-E-B?E?-BX-oE|-ooM-E----?-MB-BMB-M--MB---MoMM?-------BMB-?-X----BX---X
B?B----o---EM------o-?--Xo-MX--E-----oB--XB-----E-B--B----M--?-oM-----?-------o-BXBM-T----E-T-TB-M--oX---o-------o-B-E----|XE-------B?--B------|-?-XB-MBEE?M-T--B-M?----Xo--B---B?-----XE---?-oEE?--BM-X
MM---M-B-EB--B----?MM----?E---?-----?---E---M???-BE------o-oXE----oo--E-------------BX---?--X-|-?-----------M------------?|---X-------?----o-M-|?o----T--M---|---?o----XM?-MM-?---T-E----o----M-E--XM--B
-M------o-M----oBEM---B?----M--X-----X?------M--X----XT----?-?----B----To-o-M---M--o--B-------X---BE--oB----M--o?o-M-E-B--X?B-------------B-?--X------X-X-MX-X-X--o-?-M?M----XB---|---M-X-X-----------?M
B--X----X---o---E---o---BT-----o-o---o-Bo--o---B----XE|---M-?-?--E---?-XM?-----B-o-----M-X------?M---X---B-------B--X----?--------EM---XT--o-B?----?------------MTo-----?o--ooE-Mo|o-M------oX-?Xo--BE--
?-----B--E?--X--o-X-B---E|--?--B---?E----?--Bo-------oX-M-?E-?o-----?E------o-o-M----------EM-M?-E-o-E------------o--B-------E-?---E----|-M--o-o----?----o-oX----|B---X---------M-X-XT-?-T----M-M-XBM-Ev
?--M------E?MT-M--B----?M|-EB-E--B---?----BT-E---?-----M--?EEE-------o---------------?--E?----------------E------B-------XM--E-----E---E|--------B-----------?---|-----M-B--E---B----|---|-B-X-?---o--EM
BT------E-E-EXo--XME--?--|----o?--oX?-B-?--X----X?---------MM-XX-?-------E--M-X-----B-X------E--o--X-M??MX--M?-X-----X-M-----EM-oMEEMXX-X?---BX?o--E-B----oE--?--|M-----X-o-------E--XB--X-oB--E?E--M-oX
E|---XB--B-o--M---M--oBXMX--BEB--B---------o---E-E-o-----BB-?o--M---E-E?---X?-------M---B--B?BE-Mo----M?-?------M-X-BB----Bo--------MM--Mo-oM---E-MM?-------XE?--X-M--XE--B-X--B-X--B-------ooEB-o?----M
M|X-------M--TM--?------?-----?------?X--oT---?B-----oX-----o-X--T--T-B??--o-----o---MT-E---E?-X?E--B---o---o----------M-----?------T-E--B------B--o-o--oX---------E?Xo----M-------?-----T-X----M?-----?
B|-MT-----?--|---M--XT--M--?----------o-o-|----?-------M---------|--|--------------X-?|----M-o---E-----X----o-----?-----M-----------|---MB-----------BE--?B--XTBX--?M-M--o----------?B---|--E---ET-MT--?
-Xo-|--TM--?-|-TT----|TT-----------T------|-T-X-------------B---T|--|-o-M--------T--T-|T------------ET-----------T-------E----X-----|------------------------T|-----??-X-----TX----------|--T-B--|--|--M
m---|--|-----|-||----|||-T------T--|------|-|------T----------T-||--|--------T---|--|-||---T--T------|T--T-------|-T-T--------TT----|-------------T--T--T-T--||--T---------T-|----T------|--|-T--|--|T-?
XXXXXXXXXXXXXXXXXXXXXXXXXXXXXXXXXXXXXXXXXXXXXXXXXXXXXXXXXXXXXXXXXXXXXXXXXXXXXXXXXXXXXXXXXXXXXXXXXXXXXXXXXXXXXXXXXXXXXXXXXXXXXXXXXXXXXXXXXXXXXXXXXXXXXXXXXXXXXXXXXXXXXXXXXXXXXXXXXXXXXXXXXXXXXXXXXXXXXXXX
