-EXBXM-MM-M-?----E-ooXM--B--MM?-E-E-E---EB-M?E-?--?EX--?X?-XM-----M-?-B-o-MBMo--BE?BB---o-B-M-XEM-M-EEX--B-Mo-XEMo---oB---MX?-BXE--E-EoX-E-X--?--E-oX-BXB---?M--MXo----?oMEoB-?E-EX-M-E-X?MXooB-oMo?--MM
|-BX-M-E?EBMo-EEo--BXB-XB-?B--o--B-XoM--B-E-ooXMB--EX-MX---Mo--oEEEoMMX?-B-MMo--?-o-----o--X---B---oB-X-EEE-M?BEooBBo--EB?M-oo---o--?--?--EMM-M---B-o?-oMEBBM-X?MBo----?--XXB-BB-B-M-MoBMB-Mo?-B-o-EX---
M--EB---B---MBE---B--o-o-XEo?-EMXB--MB-MBM---EBBMBBE---?M?-X--BBB---?-??BE??M?MBoE-?BB--oX--oE--M---XBo----B-EE?E?o-B----oo-B-o?oM-?-MX-?M?E-X-o-E-oXoX-?-E-o-oX-MMBB------E---?--EB-E?oB-BEBB?---B??X-E
X-?---XB-o--M--?E-MB--X----BMB-----X-------E-B-E-XM?-B--oX---BB-?-ooo--M-B-----XM----TB-?---?-?X--BT-------------BMo-MMMBE----oo--M-X---X-o-E----X--------XE---?-XBE--M--M---B-B--?-?oM--?-oMX---E--oM-T
oXo---B-XM--o--Eo-?MM?--B--------M-MB-----M-o-XE---?X----E-------?----M-BTX---X----X-XEM-B---------XEX?E-X-----X----?--?B---??--oE--Mo----------X------BB----XE-To-?-------o-----o---oMX------oEX-o--E-?
B--B---o--BX----?--Bo---B--?XM--MBo?-o-B-----?----E--?--M-EE?----MXX-M-B-X--EXB----o--oo---M?---?--o---?B-----oM---?M-----?--M-B-?--M-XX-o----X-o-M----o--B-o-MM|---B-M-X-X--BX--?-B-E-B-?--B--o--EX--BB
EB--XX-oB----BMXE-----E-Bo-?E----E--X----E?------X-----E--E-----X--?--E-oE-M----M---M-B?---?oE---?M---B-oo----o---B?--o--M-B?--M--ETB-o-X-M?-??oM--EM----M-?T---|-EB--B--X----Bo--oBM-M--M--M-M----?oo-|
o--Xo---EMX---M---BoM----------X--X?-B------X----MM-B-?---BMX-X-??---M-T-M-----X------?B-o?M------?XB---?------o--EM-----E?EoM-----X?-B-o?-B-o-M---oB------MX-E-X--B--EM--o-M??EB---EB-E-----X-XX----o-v
o-MB-MX-?M-----E--o--?--M----?--M?-EB-?----BE--------o---------X----o--|--X------M-X----M-------ME-----X-?-B-----o--?---B----?---?----E-EB--?----M-M-EE--EM--M--o-----o-E---?MooM----E-To--?B--B-X-XEM-E
M-B----?-E-B--B----o-B--o---Mo--oE----oM-----E-o-B---o--??-MX--M--X-?--|-?--XX-----oBE----B-------?----M-o-oEE--B----?--B------E---B--BMo-oBMBX-B??-----BM--B---ME-M-E-----BB--?-EoBo--|---B-----BE-M?X?
ET-----M--M--M-----------E--oBEXo----E-o-X----B-M-o--------EB-----Eo--?|?-M----?-X-------E--?-------M-----o?MB---------E----E-----?M-Xo---B-E--XTB------o--------?---M--B-?--?Bo-o-----X----XXBXE-?-E--M
?|--o----B---E-M-------M-o?--?-E-?----o-X----MEo---X--?------M-o-o--Xo-XB-BX---o--M--M----B--E-X?o--?------B-?---o--M-?--EMB-EB-BM-B----?-----B-|------oMBMX-?-EM-----E-M----------B?--o----M---oE-MB--o
XX--?-?MM-Eo?---EX?BB--E--EBM-----o-E-E---X--E-BM---o-------B?----M--?---E----?--?BEE?--o-------o------o-B--E--E?----?-o---o---M-E?-E---B-----o-|o--BE--?M----E-----?--------M---M--?o---o--B--?B----??|
B-M-B---oB------------E-----Bo--Mo--M-E---?---X-?X-----o-X--EB----------?-X---??----o----E-XX------M--Mo-E-----EEoMX----E---X?--o?-o--B-M-XXM--M|--o---o-M--X-MX--------X-Mo--?--E----E-T-?--?--?o----BX
mo-oo-E-B--M-o--oXo?---X--oXo?X--o?B-M?X---Bo-o-EB-E-?-B-EXo-o---M-?---XM-MB---o-oBBB---o-E-oo----B---o--BX--EB?-MoEEE?-oMMXB----o-MEMM----?o??-XBMo-Boo?-?B-?EoXEBB--B?EX-o-?-?M---X-B-XE---oMXEB--E---
XXXXXXXXXXXXXXXXXXXXXXXXXXXXXXXXXXXXXXXXXXXXXXXXXXXXXXXXXXXXXXXXXXXXXXXXXXXXXXXXXXXXXXXXXXXXXXXXXXXXXXXXXXXXXXXXXXXXXXXXXXXXXXXXXXXXXXXXXXXXXXXXXXXXXXXXXXXXXXXXXXXXXXXXXXXXXXXXXXXXXXXXXXXXXXXXXXXXXXXX
