|X--B-?----B-EXoEEBE-E-E??B--BE--MX-?oE-E-B-o-X--?oMTo-oBBo--X?M--M-o----??-----EE?XXBB-MEXXo-X--EM?-X-Mo-B-M??--X?B---EoMEMo-EX-XM-BXM??-M-MXEMM-E-?M---EE--M?oBX---oMXE?X-E--E??o--ooEo-oMBX?BMoE-XMXM
TMoX--M-XX-E---MoE-XX?M-o--MMXE-EM?Xo-M------?---X--|o--E-BEo-X----X-E--MMMM---MX---BM?-B----?-XMX?MEBB--B---M-M--MB?-oM-XE-E?M--o-EB---BX--E-EE--E-B------B-M-----?M----M----BMB-o---ooB-B---?XXE?MEB--
B?-o-----XEo--B?-MB?X-MBoM--------BBEE-E-MB---o---B-|-o---oXXMXoT-o?X-X-M?BM--B?E---o-E??BE----XEoE--BMXo-X?EMM-X-X-B---EX?o-?M-?XB---XB-M-Xoo-X--ME-Xo--XM--XoM-o-B-X-o-o-M---T-BM?X--X--E-M--?XBEo-?-?
T--?BM-B?---------?---E-----?M?----BX--o----TMM----M|-o---E--E--|---------B-BM-----B-XB--XX--o-T---o-----X-?---X---E--B?--BM-Bo-M---o?o----B--MoXB-------------T-BB-----X----o-|-E--XMEB----M-X--E-o--B|
X---oo------M-------X-B--X---------M-M------X----BM-Xo----?----?|o--E-X--?M------EB------M-o---X?-E--T--XB------E---?----oBoo-oX??-B------Mo----?-EM-B?---?X--o|---?-EM----B--MXXE?--B--X--M-E---M--E--o
?X----B--XX----oM--B--E-M?--BB---M--------?--E--BEE--------BoB--X---BEo-------------?EX-EB---E-------|--B---?---M-E--?-MT----X---E?----------M------?-----?---E|---------------??M--E----X---M-?B----M-M
M?-B------E--X----?----Mo--B--?M---M--X??----o----?-E------B----?---oEo--MEoM--XEE-o---o----EB?--EE--|-??----XX-----B----o----E-B----E----?------o----o--M-----X?-E---XB?--?E-E-E--E-------T--------XEB?
o-M-X------o-M---M-----BB?BEE--o-?-----------?M----E-------M?X------M-o-o---------B--B-----X--oB-?-o-|B--XXB-M----?TB-B-X--X-B-o-E-?-----X-B-oM-M?------X--X-T--M-------?--B---B-----X--XEX|T---M-B?-?-v
T------E-M------?------M--o-oE-o-E--B-E---E------E-E----ME-----X-E-Bo-----?M-----?-M--ME--X?-------?-X-E?M---------XE------M-?--oE------B-B----M---EXX?---o-BX----?o?---MXBo?---EEBM-?XXo-B|X-X--M---oBT
?-----M?------M-??-E-----M---------?---B---o?---B-E--o-E------------EM--oEBM-X--o---E--M--B-EBX-M--oE--BE-EM-M-o-M------?-M?E----M----oB-M--E---E-M---------?---?----B---Bo--?X---B-TB----B|--E--------o
oM------?o-B-BB?M---Eo-BB-E-----o?----X-?-?ToM--o---?E--------X---X?B-E--o--EEE--M-M----M--XB-E--E-B-----?-?-----E--o-?M--MT-MXBE----------EB-BB-?o---M-o--B--X------------E--?----XXM----MX--TM-?--MB-E
oM-X---T----M--?oX--E--------X-E-?M-------o|------TX?B-B----T-MXBX----B-M------X-B--T---oX-----o------B-T----BT---TB-X-----X?-------------X-?M---o---------?-X-----X--BBE-E-?-?-M----?--?--?--XoET----ME
M------|B-----o-M--X-----------------B-----XT-----|----?----|--E-T--?---o-----?-----|-T-------T-Mo--E-E-|-E-T-|---|-T-M--------E--------------o?o------MBX-M--------------?T-?------M----M----?T-|-o---|
TTT--T-|T-----o------T---X--M-----------?X--|-----|------B--|----|---B-M-------EX---|-|-E-----|------T--|---|T|-X-|-|T---T--T----TT--------X------------o---T---T--T-------|E-----B----B-----T-|-|-----E
m||T-|T||---T--------|-------------------T--|-----|T--------|--T-|T-----------------|-|-------|------|--|---|||---|T||---|--|----||--------T------------T---|---|TT|---TT-T|------TT--T---T--|-|-|-----E
XXXXXXXXXXXXXXXXXXXXXXXXXXXXXXXXXXXXXXXXXXXXXXXXXXXXXXXXXXXXXXXXXXXXXXXXXXXXXXXXXXXXXXXXXXXXXXXXXXXXXXXXXXXXXXXXXXXXXXXXXXXXXXXXXXXXXXXXXXXXXXXXXXXXXXXXXXXXXXXXXXXXXXXXXXXXXXXXXXXXXXXXXXXXXXXXXXXXXXXX
