MX--oE?o-B?-BMMME--M-M-ME--oX-?-o---oBoMXE-Eo--MEE-?MoM-o--E-XE---M-E-?---B-?oMM-----MBBX-?---EoXMo?MBE--M----E?oB-EX-XBXXM-BXEE--Eoo---o?E-M-?-MM?--XooB-E-MB-M--M?-M--o??-Mo-XBE?--E-E-X?-XEX-?--oM-M|
|E-??-?-?--E--?X------?XMMB-??-MM-M-?E-X-E-----EX----?----oo-----M?Bo?--XE---o-XMMX-B---B--MBo--E-----E----E?B-X-X--B---ME-?M-B-XX-oo-oB---BoE----?--E--E---XX-MoB-?-EBE--B-X---E--T???--T----EBM-Bo---E
-X-?-----BE-----XB---Eo-X--?-----EE----BBX---Booo-M--E---ME-BEXMo-B---MX-M-MXME---X-M-o---o-X--?-X-M--?-X-E--------X--oX-o------M---M-o-----E---------Eo-M---E-E-E--MBB--M-Xo--oEo-|-M--o|-o-?-----B--XE
?---------oo-------TX--------TT-o------BoT--XX-------------------E--B-Mo---B----B?oo-T---X---M--M--M-o--oET-----BBo-E---M--M-X------M-------X-T---B-M--oEM-Bo?---X--oE----EM-?-BB--|E----|X-E-B------M??
-o-B---o-M---------XT-?-o-E--|XBB--------|M--E---TB-E---------EM--MM---------E-X--TM-|T--------?E-BT------|-E---------T-----X---------E-X----B|----M------To-oM??----??--EM--T--oE-|--o-T|---X--o-X--??|
o-EEo-MM--T------?T-X?M------X-----------|o--B-o-|E------E-E--Eo-----?----X---o?-MX--|X----M--E---?|?-M-E?XBo---M---E-|?-------M?------T-?----|-B---M-EM-TX------X-o-B--M--oB|---E-X----X-XB--?--------B
EM-o-?--T-|--B-M?-|----?--------M-TB---?-X?-?--?-Xo--E-T-M---o-EB--E-E-----BXB---MT--X--ooM-T-?----XoB-B---ET----BM---|--XB-------BoB--|--MXMMX--------?M|----EM---o---------X--o--?--?--X----------MB-X
B--B--?-X-X--EBo?-|---o-M-MB-XB---|--o-----X--Eoo----o-XX--------?-----?--XoM----MX-B-o-----|---B--M-M---M-?|?B-oM---X|o------o----?---X--E--T--M-------?X-T----T--M?-B-------------T--o-E-E-------X--Xv
ET--------oT-----T|-?oT---------BEX-??--M-------B----E-T----?T--M-B----?o--o--EE---EM--o-o--X-B-T?---E--TE--X?----M---X---?-------EB-------E-XB-------oE?--|-Mo-X----M------E-M-----XEB-MMB-o--T-------?
-X-M-------X--?--XXE--|--o--o-??-M-B----?o-?----------BXoT---X--?M?--oMM--o--E----B--E---o-o----|oo----oXo--?---?-E--T---B-BET-B--B--?o--T-o--?---TE-----o-X---?-M--?------oE?---?E-B-BM--MB---|-------E
TM----E----?M-E?------X--EBM----o---X------?----------M--X----o-?------M-E-MX-o----?E--M--B---T?|-M--?------E--EM----X-B-----|-E--Eo--oB-X------BoX------M-----M-----M----------BMM------oTB-?oX-----M-T
E------?----o--------B-----o-------------T--E-T----o---E----o-T----o--------Eo----------XTMET-X-X---------E------T-oX----T---X---------------T----------------T----o------------T---?-T--TX--M-T-------X
?-B----------T------?-T-T------o---T---TTX----|--T------------|----T-B------T------------|-E|--T-----T-------T---|-TB----|--o-o--------------|----T--Eo---T---|TE--------X------|T----|--|--?T?|E---T--B
o-T---T----?-|T-------|-|----------|---||--T--|T-|-T--T----T--|----|--T-----|---T--------|-T|--|-TT--|-----o-|---|-|-----|---T---T-T----E--T-|----|T--T---|TT-||T--T----T-------||-T--|-T|T--|-|-T--|TTo
m-|---|-T-T-T||TT-T-TT|-|--T-TT-TT-|--T||T-|TT||T|-|--|T---|TT|TTT-|-T|T--TT|TTT|--TT---T|T||TT|T||-T|TT----T|-T-|-|---T-|T--|---|-|T---T--|T|T-TT||T-|-T-|||-|||--|-TT-|---TT--||-|-T|-|||--|-|-|-T|||B
XXXXXXXXXXXXXXXXXXXXXXXXXXXXXXXXXXXXXXXXXXXXXXXXXXXXXXXXXXXXXXXXXXXXXXXXXXXXXXXXXXXXXXXXXXXXXXXXXXXXXXXXXXXXXXXXXXXXXXXXXXXXXXXXXXXXXXXXXXXXXXXXXXXXXXXXXXXXXXXXXXXXXXXXXXXXXXXXXXXXXXXXXXXXXXXXXXXXXXXX
