?X?oE?-o?XB-E-MoX-E-EEB-?XX?-XM-o----?oM-o--MM-?B--oX-oX--E-?-o?-BMEo-E?---BE-M-Bo?M?o-E-E-X-o--?XEBE--BE-Mo-BX-XMB?--BME-MX-MEEBMo-?o??--X--M-XM--XB-BMM--E-?oBo-X-?X?-B?-M?BE?MXMMBo-Mo?E-Eo?-XB-----o
BEEE--M?MMo?XB-Xo-EX---BE--?-XEEo?-X--E-?-X-MoM-?-T--B--o---?o-oB--ooEM-o-X-Bo?--MEEE--?-X-o--??XMB-o?---XBoo-oo-X-X-X-?-B---oEEX--------?--?---M-??--E---BEBBX?X---E-M-BEX??X--EM?M?ME-?---EXEE---?---M
--To---------MB--B---MM-?Eo-M--MXo-BE-?MB--?E---E-|?---o--M-XMEoE----MM?o-M-EX--BB--BX-ooEME--o-B--?MM-ToE----XE?---?-----B----M-B-E--Mo?XX--B-oM-M----M--M-E-o-M-?Xo-M----E-?--o?---?-XoXo?oM-o??M-?M--
T-|?-?--o-XE---X?-o-M-E-------?-M---?-X---?X------|-o-Xo--M----B-E--o--?----------B-M-TX---M--------?-B|o------M--E---?E-o----B-X-B---E--E-B-?--X----Eo--oB--EoM?---TTo-BT-E--o?--o-M----oEB------?-Mo-T
o-|--M--E-T-E---B-B----E-o-X-B-B-----M-EoT-----TX-T--E----EX------X---M---B-M-o?X-oo--|M----XX---X---M-X--B--T--E-B---o-----E?o-Mo-X---EM--?--X-----X--o------M-----|X---|----?--M-M----o?----T-M----E-X
T-X-oE---oX--------M--------MBE?--X------X-----XE-|-B-------E--B----E----?--------B---X?-----o--B----?E----BMX-E-M----?-o-B----T---E-----M---?M-M---?-X-------B---T-|B?--XBEXB-----?--X-----o-|-M-E----X
-?-TB--------EMEE-----B-o-?-M-M--Bo----M------E-o-X-Eo-M-M---M----MM---ToB--BM---------o---------E---ME------BXMM-Eo------BM--E|----X-ME-M--EBE-----E?---------Xo-|T|oM-oM-?---?E--MM------X-o|TBoMX---o
T--X-B--B----?E-?------B?X----E--B-------X?--?-o-X------XB----------B-?X-------?X--X-?-----BE?M--?----------------o------M-----|-MX-MEo-oBE--M--E-MX--o--------o--||X--X?TX------------Xo-----|X--??TX-v
?-----o-------EX--M--o---?---X--X--To-M-E---E----E-------?X------XEo--M-M---BB-EE---EB----?-MB---M?M?-----ME-M-XB--MEM?--------|o?--M-----TMEB--?X--MT---X-?-XEo-?XX-----X-BM-E---------------X---B-|o-M
B--B--M?----E-------M-X---EE--o-B--X---BT-ME-M-----T---?T-o--X-------?-X--XX---o-E?--?-X---X-o----o-T-M--??--?--o?--ooE---?-oX-X--o---M---|---B-----?XM---o-o---?o-----?XM------X-----B------X----?-|?-?
Bo-----M?-M---M-M-E-E?---E?--------E--M-XT--M----BX|----X---oE?--XoEE-o-----M?--B---X-?-XTX-E-X-?---X---B------EM-X----XoE--E----EBM---T--|-o-------?--o-B---B----E----o---Bo?-M-MM----M---BXM--M-B-|--E
o?------?X-o--------MM----o-------o-B?--TX-T--T--B-X----M--------?----T-----B---------MM-|-----------E-B---------M--------M---B--------|--|-oM----B-------M?-B-o---o-----------E------------BME--TMXX---
B--------------M-----B--T---BoMME-M---T-|--|--|----?---o------o--TM-M-|---M-?----?-T---T-X------------------Mo--X----TX------M---X---B----X-----X-----X-T---?------M----------E-B-B---?----------|-----B
M---XTT-T--T---B--------|--T----------|-|-T|--|---T-----oT--E----|----|----TE----?-|---|M?-T--------T?--X--------T---|T----o-?---------T--TT-X--T-----T-|----------?-?-oT-------------oT--T-T----|-----M
m---T||-|--|TT-T--------|--|--TT--TT--|-|-||--|---|------|T-----T|-T--|----|----T--|-T-|---|------T-|------T-T---|--T||----------------|--||----|-----|-|T-----T--------|----T---------|--|-|-T--|-----T
XXXXXXXXXXXXXXXXXXXXXXXXXXXXXXXXXXXXXXXXXXXXXXXXXXXXXXXXXXXXXXXXXXXXXXXXXXXXXXXXXXXXXXXXXXXXXXXXXXXXXXXXXXXXXXXXXXXXXXXXXXXXXXXXXXXXXXXXXXXXXXXXXXXXXXXXXXXXXXXXXXXXXXXXXXXXXXXXXXXXXXXXXXXXXXXXXXXXXXXX
