--M---?-oo-?MMB----Bo-MME?EXXMEMM?M-oM--E---X-MM---MXE--B--MMM--o--Mo-XMM?--?EoMX?X--?X-o---?MX?-BoEXE--o-?-B--E-M?E-BBX-X-XMM---?B---oooEX--M?MEEEooM--?-M--MEXB-X--E-M?-X--oX--o--MB----BB-M---o-MBXBB
MoBXX-B-----E---BBMB-oT-o-?BBBooo--?--B?--E---XX--?BX-o---M-??---E?oEM??o-Eo??o-TE---M-XX-B------?Bo?-M-B--o-ME--?---?--X--X-------M---o---MBE-B---E------B--E-E?oo?XMoEMB?-EX----?X-oX----EE-XX?-o--?MM
|E?M---o--o-B----o--oE|-EEMB-M?-?----B-?MB-?M--M-o?-M??--------B--XBM--?o----B-X|?-X?-----BE---X--oo-ooBE--Bo-o---XXME-E-----?E-B-oXB-X-------?-----oM-X-MXXMM---E-?E--oo-MX-X-XE-BB------MB--EXB--E--BM
B---------?---o------E|M--------MBE?-?-----------o-o-----?-X--?oE---?-?---o-----|?E-------ooMB------?--M----B-B?----oooM---o---?B---M-M-?o--------E-M--B--o--BX--X--------o---M-------------E----B?oB---
E-------T-?E-E-B--X---|-BXME----M?---?-X--o--?-oo------oBooM-?--M----MB-?----XX-|T-E---------E-B-----XEE----?-----T-------BM-M--M-MB-B--o-------B--?E-B--ooEB-M-?-EX-MB---o-?E-M-M-M-?---Xo---BB---?---B
?-XM?---XEB-B---B--?--X--B--?---?-E--?--M---X?--E---BE-?---o----M--E---E---B--M-X|-------?-XX------ET-----------X-X---?-o--B--B----E--M-?--------Bo-----E??-?-?o----ME-?-?-----BB-?MX--MXT-X----E-M--M-X
XX-----M--E-?----T------X-?-E-EM--?MX-ooB-EM-o--------?-------------X-M--E----E--|-oM---T---?-E-??--XB--X------o-E-?-------o-------BB----BB----?--E---B?----MXMB---?-BXo------Eo--o------|----------M--M
|----M------E---MX---?EE?---oE----o---o----B-T-E----o---?B----o----------T------X|XB----|------Xo---ME-X---E-----------X------?E?---------o-X-M-----------X------T-o--B?---B-?----------MX--MBM--XB?E?-v
BXX?B---BX-?--B?-T---B-----X------E----B---oEX-?-E-MBB----M--------E-M---X-o-X-?-X--?--BXMo----E--E---o-XX---BE-E----?B-------o-----?o-E-?ooo?o?----MBME?o-M-XE--|-Eo-----M--EM---E-?-X-------E-----?Mo|
-E--M------------X-M----XM-?--M---o--B---?-B--E-X----oE----o--B----------o-o?----?B-----?---MMM-X??--M--M-o-o-B--M----M-----------------?--oTB---oX----B-----B-?o|M-B--?-X-X------B--M--?M--BE-E-X-?oMM?
|---oB-?-MXXMX?----Eo--XB---M-B--M-BTB?--?o---M-M----o-XEo-E-T-B--E----B?E-MB----EEB---BMMo----Bo-E-EM-oE--X---B----?-B-X?--XBo-B-B---T-E---|-----oM?--M-EMX----MX------Bo-----X---oE----o-X-o---B--E--X
?T-?----?----------------?X--B-B----X--X----o-----M---T------X--oX--M?-E?-B-o-EE----E--?---BoBX-MB?----?---?X--MTXX-E-oo--E-o---------Xo--E-|--E-B------B--MX---B--X?M------?---X----T------oTB-----EoTo
?|------o----------M--E-o--------------EB---BM---M--?-|---------E----------E-M-?-X------E-----o----T-B-E------EE|T------o----?---------M---M|------------B-B-----E-----XM---------B--|--o--oE|-?-B----||
o|--------T-------T-----?-----o-----T----------B--T---|------------T---o----?-------o-T-T--TT------|------?---?-||?-------TMT---------o--T--X-------B-TM----------------?-B-B-M---M--|---M--T|-o----TM|X
m|T--T----|T------|T---T-------T---T|--------T--T-|---|----------TT|----------T--TT---|-|--||----T-|-------T-T-T||--------|-|------------|-T---T--TT--|---------T------------------T-|----T-||------|-|E
XXXXXXXXXXXXXXXXXXXXXXXXXXXXXXXXXXXXXXXXXXXXXXXXXXXXXXXXXXXXXXXXXXXXXXXXXXXXXXXXXXXXXXXXXXXXXXXXXXXXXXXXXXXXXXXXXXXXXXXXXXXXXXXXXXXXXXXXXXXXXXXXXXXXXXXXXXXXXXXXXXXXXXXXXXXXXXXXXXXXXXXXXXXXXXXXXXXXXXXX
