BXoEooM-Boo--E---BM--M---?--BX-?M-Xo-o------XE-o-B-o-B??E-o--E---MEo-Mo----?BM-E-?o-oMo?-o-X---M--o-MBEM?E--?o--?-XooE----o-BM?X?ME-----E-XoMEEBX-ME-M-E-?--B--M----MEMo--?B-X---E-oo--?B-BMEX--E--oX--X
?--TM-MEB-XM?-M----XM--o---XE--EE--o-?XM?B--BoME-oMX-XEMMX-?---M-E??--o-X-E-?-E-BMooM--MM--o-oEE---o?MoEMBX--M-?B-?--X--BB--?-----M-E?-ME-oBXE---X---?o-M----?------T?X------o---XMoM-?-X?---X--X?oMEo-o
BXX|-???o?--Xo---BX-----?--BT-BXB--X-X-------T--BEE-EEoEM--B---EooX---?---B--EBB-E--T----ooEEXBT-XToo?o?--T---MM-------o---E----X---M--BBX?-EE-MM-o?X-X?----M-o-X--X|-X-X-E-MX---X---ME------EMB?B-E---X
M--|-X-------?-M-X-o--oE-B-B|-?--------EEB-X-|---XT----B--o------E-B--?-T----X---?-X|------M--B|-o|-----Bo|o--??E--o-B-----X-B-E--EX-?EB?B---?-??X?----o-------E--Eo|---X?o-------?o----M--?M-?-XoX??EoB
---X--EE--M?-----oB-o-------X-----------M----|--EM|---B--E-X-----?o-M---|B--?--?----X-------M--|?MXM-X----XMM-M-B-----B?B-X-T-ME-o-------XEXM---E--EoME---X--Xo-X-?BX----MX?-M--XE---E--M-X-M-------B--X
|---o-T-------Bo-M?M---?BMB---BMo-TM-?-?--XB?|----|-----?-?--XB-o--E-BEoX-T---M---------B?M---B|--TEE---o-----o---o-X------X|---?E--------------E-BM-Xo----------T-?-B----oM?--o--?--M-E-----E---------?
B--B--|---M-B---X--?--BX--M-?-----|-E-B---MEEXM-M-X--M--o-?---X----B--TM-M|B--B-o--E-B------E--Xo-|E----o--B---B---oEEE-E---|--EMM---X--B-----ME?-?---------X--B-|---X--B-X-----ME-oo---E-XM------M----?
M--X-TXB-?-X--M-oB--------X--EooM-XoT-?--B---o-E-?-o----------M-E--MXM|-B-|-oE------------------M-X?B----EMo-------B-?o-----Xo----?E--X----X--B-?---B--?-M-o----B|B-----------E--B--M-X?--MXB--XX-?o---v
-----|?-M---------?o?----M-B--?-o---|---XE---?BM-B-?o?-E-------XoM-EX-X---XX-?-??---o-B--o---------T------X-XE--X--------B----o--EMM-M?ME--------M------------o--XX-oE-------E-------MEM----E---M------B
M-?-MX?-----?----?X--oE-o-?--M---M-EXMM---?---X--XM-E-ooE-----M--------o-------E------?-o-------X?-|o-MBo-E-?---------B------oo?B-?B---E--B-B---??---o--X-B??-B-----Eo--M--EoB--o--M-------?B?-oM?-M---B
B-B-XM--E?--E-BXM?-XM-M--M-------Bo?o--X-?-XB---------M-Mo-M--?-M---E-M?-B?M----MMXX-B-XE-?-----M--X--E-B-X?MM-M?-o-X--oB---X-MB---o-------B-oB??--?E-----?E---M-?E---X?EXoEo----EM--?-----M----M--M---|
?--M-B---X-X--M---T------B---X---o--T-----M-----------M-M--T----------M------M-E--------X----?---XT-----?------B---MTo---TT-------E--T--o-----------T?---TTT-?----M-E-M--M--T-----MM---T-E------?--Mo-TT
TE-E--------------|E------T-T-------|--o------o----T-T-----|-T-TT--------T--------oX---T------M---|--BE------TTT--T-|T-T-||B--T-----T|--------X---T-|----|||TT-o----TET-----|--T-----T-|--X-----------|?
X-----T----T---T--|T------|-|------T|---T----------|-|--T--|-|-||T----T-T|--TT-----TB--|----------|T-T--T----|||--|T||-|-||-o-|---T-||T-----------|-|--T-|||||-TT---|-|--TT-|T-|-----|-|--T-----------|-
m-----|----|---|--||------|-|------||---|----------|-|--|-B|-|-|X|----|-||--||-----|---|----------||-|--|----|||--||||-|-||---|---|-|||-----------|-|--|-|||||-||---|-|--||-||-|-----|-|--|-----------|E
XXXXXXXXXXXXXXXXXXXXXXXXXXXXXXXXXXXXXXXXXXXXXXXXXXXXXXXXXXXXXXXXXXXXXXXXXXXXXXXXXXXXXXXXXXXXXXXXXXXXXXXXXXXXXXXXXXXXXXXXXXXXXXXXXXXXXXXXXXXXXXXXXXXXXXXXXXXXXXXXXXXXXXXXXXXXXXXXXXXXXXXXXXXXXXXXXXXXXXXX
