?M-B---M------MM-MX--M?-MM-XBBMBoMEMo-X---ooX-?--M-?oMBBo?X-BX--Mo--o-?---XX--B---MXE---E-MEE-E??---ME?-X??E-X----EB--Xo-E-----MBoXX-B-?E-o?o-?X---EMBB-EM??EBE-EoM-XBB-XBooEoX---E--E-EBTE??X?o-XXM--oB
|--M-o-EE---??XoX-o-XoEB-?Bo-BE---E-?-X?BM---?E--o----?--X-Eoo?-X-E-XB--oEoX-----MEXMMMo----oMMXX----?o--E-o--E-oX-ooXX--MEX-E-?-?BB?B--?-Xo-M--XE-EE--o--M---?oB-?--E-??--oB-EXMo-?-M?-E|?Bo--X-E--Mo-|
|-Xo-E?---o?-XEX-E---o??MXX--?---o---o?X---o-X-M--o-M--XE--?-?--MX-ME-o------X--M--BMBBT?-o--?-B---TM--o--X-----MM?--B-o----o-----M-X---oEM-----X-B-o-ME-??X----BE-B-?--M--B--MM?X?-X-?-X|ME?-----M--BMo
TXEM--------------X---Bo-X-X--?--X-?M-o-----X-B----M-X--?---X--M----E--M-BX--?-M--?----|---E---o-M-|-----MB-X-X-----EX---------XX---E--B-----Eo-EB--o-E-E-BX---------?-------MB-----?-XB-|B---oXE-X----|
MM?-TMM---E----E-?-X------?---------------?-ME--M--M--X--XEB?--o---E------BB-----BoM-?-X-B---------|-BT---o--??--------o--XB----?-BEoX------E-------B--?---?X-XXME-?-----B-X---EoXE?-----X--o--E---o-M--
TE--X-B----X?-----MB-?--?-E-B-------o----o----E?o?o---M---?B------X--------o--o--M-----M--XX-----Xo|-o|----E----X--?---E--B?---X--M----E?ToT--o--T-----o------E-?--o---o--E---E?-M-?M-X--E--M-?-E-X-E--?
oM-oM----X--B----------------?-???-?-------o?----------?-E-------ME---XM----oMEo-M---------E-EoE---X--X------------?----o--oT-----E--XB?o|E|--?XoX---------------------M---EE--M----E-B-----o-E--T-E-o-|
M--o----T-X---B-----o-o--------o-----BEBB----?-E-------?----M-------XB---E-E------B?M---o?-----M--M-EE-----o---XX--B-E-X----|---M----B-oT|B|-o-----MB--?-o------E----?----o------M------o--X?-?M-|B--B-v
E-E----EX---X-?--M-----X-oM-B-oo--oXET------M--------XM-M--B------B-B-------?o-o------oX--E--XM--?E?-M------M-------?oE-E-B-X-EXo-B---E-XX-|B-BXo-X-EX--E--M----------oMX-B---X?--------BB--E-M--Xo---B?
X---BME??--B-BB--o--ooB-E----oM---M--X---M----o?MM-o--?o-EE-----B----M--M-------E--?------E-M--------M------M-----------o---?--?B--EMM-M--MX---EoMoB---EE-o-----E-B-E--o--E-M----X-?Mo?--M?-BEEoB--EoBTX
o---M-----BB--Mo--MMoE-o?-TME--B---X-o---?M------E--BX-----MMEo-----?---B-------Bo-B---B----MM----X--?-M-o----X-XE--B----BBE-Mo-M------o-o----X---B----o-----oX--E---B---ME--X-E--E--o---E-----BoXXEE-|M
X----E---Mo----?----EE----|MMX----M-TT----B------E------o-T-----T---TEXT---------E?---?-o-----B------E----?-BX--M----T-M--T-----o-M-E-?----?E-----------?-----Bo--M?----E-----o-X---To-B---E-----?o---T?
M----?---MT---?----------B|-----T---||--------E--T-M-o----|-----|T-o|-o|-------T----------------B--------------------|MM--X----T----o--?B---------M-----E------?---------T----------|---B---M-X--?M?--|X
E-----?---X----BB--T------X-----|-TE||--X---o----|-------E|o----||--|--|-----MT|-------------------o---M---M----o----|---------|-B-------T---------?--T--E-------T-------|----?-----|----o------------|B
m---T--------T-----|T-----------|-|T||--T--T---T-|--------|---T-||--|--|------||------------T--------T---------------|-----T---|---------|--------T---|-----T----|-T-T---|-T--------|------------T----|B
XXXXXXXXXXXXXXXXXXXXXXXXXXXXXXXXXXXXXXXXXXXXXXXXXXXXXXXXXXXXXXXXXXXXXXXXXXXXXXXXXXXXXXXXXXXXXXXXXXXXXXXXXXXXXXXXXXXXXXXXXXXXXXXXXXXXXXXXXXXXXXXXXXXXXXXXXXXXXXXXXXXXXXXXXXXXXXXXXXXXXXXXXXXXXXXXXXXXXXXX
