-o-E----Eo--?-XMBoXBEM-MM-M-B-E-X-?-BEEo----EB--M----M-?-Bo-X-MM?-M--Bo--X?ME--??-o-EM-XXB--MoE-oXEX?B-E--EBM--XX?M------B-E-o-EMMo?B---MEME-MX-----EBE??B-o--o--X--E-MMB-B---M??X--M--M----M-E-EoB-??--
-o-??-o--ooXB?---M-X?-oM---BM-BX-?o---oo-?EB-E?B---X-?--?-M-?BEB-X--M---o---B--ME-BE-?EM-Mo---oM-BB---?--E--EXB?--?M---BoBE-BX-oEE-XEB-BE?-Mo-Mo----EM--oM?oBo-oMMX-MM--X-MBM--EBX?EoME-E?M----B?oo?Xo--
--EM--E-oB--?-M-ME-o-o?E---X--X-B---B-?-M-M-?X----X-oXo??o-?---o-?---E---B-----?o--B--M-o-Eo--EE-o-M---ME----XMB-?-B--E?EMo--E-o-------XX---M--?X-o--B-BMEX-M-M-M-o?MX-E----MX--X-?-M-E--?--M--o?B-E-o--
--B--------------o-----X-------M-E-?--BoEM-E-----o----Mo-B------B?ME-o--Mo?E-o---o--BX-----BXME--E----E-E--?E---B---XoB--XBX---BX-B?----Bo--Eo-----X-B--B--EM--M----?-E--M-?--?--XM----MM----MX----M----
----------oMBEB--B---B?M-----E----------oE--M----BBME-MoB-Eo-B--oB----o------?------o-M----B-M-------XM-?oo--------E-M-----o?------MX-X-B---?----?o--?M----B--o-Mo----B---o--------B---BM---X----X-M----
---B--o--o---B?B--M-B-BM-?-?B-----M-E---ooM-?------E---TBBo--M--------B---B?E-M-M----B-?--o--------?B-----M-----M??--------E--EXMXo?--o-------X--o-E?MM--MX-X--------?B-B--oM?M?B-----------EB-B-?--B---
----X----ME--o?---M-----E----oB----M--o--?-M--EEo----?-XB-E-------B-----M?oB---?EoE--oB----XB--?---M----E----oX--?---EM---MBM------o--oM-----o---?--Eo?----M------------o-o--B-?B--E-------o?-M----o----
-MBB---?--M-B-MX-X-----Bo-BE-o-BMB----E??----X--?M---?--o?--X-----Mo----o?B---?-------o--XMM-----BB-o?--B--X?--T------o---B-------?-T?o-XE-XBM-M-?-B-------o--M-B---M-B?-------MB---oE-------EE--o---??v
------o--EB-?E?oB--B----E--M?--M-E------o-o-Xo-o------?--oo?-B---X-----X??M------------B-Mo---E-B---oBEo--o----XBB-B-B--B-oMX--?o--X|?MEMo---E-?--?o---o--B----ME?-----E------B-M-B------------o-o--M--f
--X--BB-?-----M?-M-EoM?---B----M-M-M---EEX---M----?--EM---MEEo--Mo--BB---B--BX-X?--X--ME--------BMME----M---BX-ooB-o--------B-M----EXEB-B----------?M----------?-o-M--B-o-E--M?---?------?---E--?--oB--f
--o--E--BM----?--------------E--B-X-BE?-------M---o-X-?E----o------------?-EM--B-o-oX--o----B-?-------X---?E------XE--oX----ooo----o--MB---M?B-oB-M--EM----------o?o--oX---??----?--oEooX-?B----B?-?o--f
--EM---X-----B--E-?-M-?---E--------M---B---------Xo-o----------B-E---?oX?-----?---B?----?-----------B-----?--B-BM------M----M-E-?-E-?----TM-o-E?M---E--?-?-B--------B--oo?-o--o-B-?-???---Mo---Eo--o-T-f
--ET--MB-----------B-----X-------?--------oo-XX--B--??------X-----M--------oo-o-------M----------BB-?-EXEE-o----o-B--------EEB--XXE--MX--|EME-----MB--Eo?-o-----------EB----M-o--X?TE?---ET-B-BM----EX-f
-M-|-MBE-M-----B---o--?X-o-----ME----X-MM---o-E-X------XX-o--Bo----M-Xo-BXME-?E-M---?BMMM----M-M---B----oM------M---E--MMo-?--------E?-E-XM-E-M-----?-BM-?-o-E----o-M-o?M---B--E---XE---?E|X-E?--------f
m--XMBE-EEXB-Xo--X-E-XME??----ME??B--?M?--BXoo-o?E-?o--B--oBXB-M-B--BM-X-M-Eo--X?BMBB-oE-EM--MBE-E---o?-M-Eo--X-B-MME-?-o--?MEBBME-----oX--oMX--MXMX--?-Xo?BX-EM-EB?BEMM-BEEM-E--MEMEB--EoX-MB?-E-XE-M-f
XXXXXXXXXXXXXXXXXXXXXXXXXXXXXXXXXXXXXXXXXXXXXXXXXXXXXXXXXXXXXXXXXXXXXXXXXXXXXXXXXXXXXXXXXXXXXXXXXXXXXXXXXXXXXXXXXXXXXXXXXXXXXXXXXXXXXXXXXXXXXXXXXXXXXXXXXXXXXXXXXXXXXXXXXXXXXXXXXXXXXXXXXXXXXXXXXXXXXXXX
