MM-B-Mo-E---E-?--?--BE?---oXMo-XoB-EEE?-oMB--o?-X-MEB--E-BB-E-B-B-B?o-Bo-Xoo-XE-E?XE-?E----o---o--XM-MX-?-M----XE?------B?BX?-?-oE-XBBB--o-MX?XMMo-o-MX--EEM?B---?B--MEBXoB-EM--?o--??-oBEME--MBoEE?E--|
E?----?B?B?XM--oEM--?--BX-B---?-----?o-M?o-E--o-?-M----XM--oEMBM?M??-o--E-Bo-Boo??EMX----XX-EXMoXXB?-oXooE-Eo?o-BB-X------??E---B---X--?o---B--oEEME---X-MM-EXM-MB--BoBoEBM-----E-Bo-EX-?o-X-BB---o--M-T
BE?XoE--Moo-o--o?E-EXX-XEX-XX-?-??---B-?--EBE--Eo-----BoE----?MBM-BE--EoMEX-M--?-M?oX--E-?-M-M--oXMM-E-E-X-X---B---E-M-X?MXE?Xo--oM---E---XXX-E--BT?-oEoE--E--?-B-Mo-X--B--B--E?-BB-EM---XE-M-Xo?----M-|
T--E-----X---B-E?XMB-B-----?--M--B-o-o?-oo-B-??---o--M-BoT?--o---MB?Mo-?-?-M---E--B---------E-o?-M-----oM-X-oM-XX---B--o--M-B----B--?-XEo--E-?---E|BM--EEM---E--?X-B--?--M---o?-----XM?----X-E----XX---o
T---M--X-M----X--?EB---XXEo-B---BoX--E----ME-E-E-X--E-M--X-E--E-Eo--MTM---BE--o?E-E---B--M-XB----E---E---E--B-o-o-oM--BBB----o-B-oTX-?M----E-B----|----Boo----B-----ME--XB-X---B-EM-EM-M--o-EB-E-----MoE
To---M---BB---B-?M-EMX---B-EE-----E-------?----?M-?M-Eo--M-B--------?X--X-B--X---X----ME------M-M-------M?-X-oE----B------o-?-EM--|oX-E--XoM-B-M--|--M-M--MBT--o?---M--ME-B----M--E-?-X?-oo-T----o----EB
B-EXTM------M--o---?M-XBM--oE------BE--?-E?---B??B------------E----o--E-?--X---B-?---E---B-?-?---o--B-----?-?-?-B-----oMo----M?---|---?-M--MoB-?B-XME---?-?E|oE--B-B-X----------E--B-X-E----X--Eo-B----|
|-B-XEXo?----oB-M--ME-M--M-E-BB----o-----?---M-B-E--M--E?X---T-o---?--E------------BM?---------M--X---M-----E----B?o--o-?--MoM----X--MM-----?o--------X-----|-?oXB---BBB--X--Mo--XMEE--oo--E-M?-M-?----v
MM--M-MoMBMXX--?----------X?-----o------Bo?X-E----X-MEXEoo---XB?-B-B---E--?MX---B-----------EB-----o----oB----X--M--E---?-o-E-ME---MBB---X---o--XX-?-M--M-X-|---o-B--M-------E-?---o-E?-Eo--o-E-o?o----M
ME--MBM----M-----MM-ooEBX---M--------o---B-oX-B?--o--o-----?---Eoo--E--T--BM-M--MB-o?---X-----ME-X?-----B----X--?-EM-X-----X-?-?---MME-X--E--M--B-X?-M------XX?E--o-?--E--oB-?-B--X----BBo----MX--B----M
B-------XX--Mo-E--?M-M-----------B--o-B---B-Mo---Eo-B-???-X-oE-M---o-M-|--?------TB------?--E-E?o?----X-?------?-?B---E--?B-?-----o----E-M---BE-B--B-o-E---X-BE--?---B--M---E-BoE---M-----M-X-T---B---EB
T-E-------B-M-?M--B-X----?--M?--?M-----?--?---?M------E---E---MB-B-?---|------M--|-B-o--E--X------E------oM-----X-M---E-------XX---EE-?-X------T--o----MXoMo----?---E----M-M----TB-----EM-oX--X-E---E-??
|X-MBB-B-E-------o-XE----T----M--?-B-M-------MT-o-?-----------M-X---XX-|----?--o-X--T---E----B-?X?-X-oBM--B--------------TXXX---X------ME------|---M-EM-B---E-B--EMXB---oE-?X---|------E-B?-EME------E--
T?-o---?M---?-----E----o?|XX-----E----oXB-----|M----?-------XT------ooMXXX----B-?-o-|-EB-XM---X----------M-?----?--------X-?-B-----EX-M------T-|--X--EM--------MB-M-o----MM----B|---?M----T-o---?XX----?
m-----------------------T|------T-------------|--------------|--------------T---T---|--------------------------------------------------------|-|----------------------------T---|---------|--------T---T
XXXXXXXXXXXXXXXXXXXXXXXXXXXXXXXXXXXXXXXXXXXXXXXXXXXXXXXXXXXXXXXXXXXXXXXXXXXXXXXXXXXXXXXXXXXXXXXXXXXXXXXXXXXXXXXXXXXXXXXXXXXXXXXXXXXXXXXXXXXXXXXXXXXXXXXXXXXXXXXXXXXXXXXXXXXXXXXXXXXXXXXXXXXXXXXXXXXXXXXX
