----------E---------------------------o------------------o---------------X---------------------------------------------------------------------------------------E----M?------------------------B-------
---------------X----------------B------------------X-------M-------------E----------------------------------------------B-------X------?--------------------------o------X-----------oE--?--------------
-----------------?-------o-------------B----------o------E------------X---------------------X--------------------------------------------------------------------------M---X------------M---------------
-------------X---------?----?-----B-------------------------------------------------------------------M--------------------------------------------------E---------o--------B---------------------------
---------o---------B--------------------------------?---M-----E---------------------------------------------M----------B--------------------------------------------------?--------------------------X--
------------------------------------------M----------------------o?--------------------------X--------------------------------------E--------E---------X------------------------------------------------
-------E----T----M-----------------X-----E-----M--------B------------------X--------------------------------------------------M---?-------------------?--E------------o---------------------------------
------------X----------------B-------------------------------------------------------------------------------------------------------------------------------------------------o-----------------------v
-----------B---B------------------------------------------------------------------------------X----------------B------------------------------------------X--------------------------------------------f
-------------------------X------------------------?------------------XX------------------------------------------------o------------------?------------------------------------------------?---------X-f
--------?------------------------------------------------------------B------------------------E--?-----T----------------------------------------------------?----------------------------------B-----E-f
---------------------------?---------------E---------------------------------M---------------?---------|---M--------------------------------------------------E-------------?--------------------------f
-------B------------------------------------------------------------------------o----------------------|---------------------------B-------------------------------------------------------------------f
-----------o----------------------------------------T--------------------------------------------------|-----------------M-----------------------------T------------------X------------------M---------f
m------oX-------------X-------X-X-------------------X-M----X----------------X-----------X--------------X--MEo-X-------XX-------X-----X--X---?-----X----X--------X---XX---X-------X------------X-----X--f
XXXXXXXXXXXXXXXXXXXXXXXXXXXXXXXXXXXXXXXXXXXXXXXXXXXXXXXXXXXXXXXXXXXXXXXXXXXXXXXXXXXXXXXXXXXXXXXXXXXXXXXXXXXXXXXXXXXXXXXXXXXXXXXXXXXXXXXXXXXXXXXXXXXXXXXXXXXXXXXXXXXXXXXXXXXXXXXXXXXXXXXXXXXXXXXXXXXXXXXX
