X-?EM-B-oE?M----E?-B?BBB-BMo?-o--MBMBXM-E-?--B?EXX-?-B---o--E-??Xoo-M?BBE-XMEoX-o-?BM?B--?XE-E-oMo-----MMB-EE-M-BE---?B-?M?--X--XoE-MMMEM-B-BEoXo-XM-Bo--BBMXE?----?-o----?-E-o-?M?EBB-M-o-MoXoXX?--E--T
B-X?Mo--M--?o--B-oM--BEXo--Mo--oX---B-?X-XE-ooo-MBX?MEMMBooBX?-M--T-?o-oMX--E---o-M-M------o--B--o-?MBM-B--?M----XMo-XoXXM-?o-?-oBE-X---Xo-o-?o-----o-X-MMX-X-?-?MM--M---X-----oM?B--MXoo--?----XBEEE--M
M-?X--EE--E--B-E-oB--o---Bo-??---X--o?-?---?EE---B----o?-BEXMEMXo-|?o--------B-M-E--E-X----XBX?-BE-?--XX-----E--?Boo-o??-B----?B--B---ooBE-M--?o--X-??M---?--o-E-E---M?-B-B-?-X--X-XB-o---EX--?o-----M-T
M--o------XXE-BX----EM---X-M--B-----X----------X-----M-?---X---o--|--?-TM-----X--?-TE-----o----M--Bo--X----BME------M-Xo----?M--B-----o---?-MBB-XM---T?o--o-M----M--B?oMo-o-B----M-BoX-----Moo-E-E--M--|
X--BMX-?---BB-M--?-TE--o---B--?-X-E--o-----------EE-?---X-X-X--BM-X---o|M--oBo-?---|MBBM-X------------o--Xo---X------B--B---??-?-BM?---M------?--BT--Xo----BM?--o---o--M---E----?T-Eo-?-E--B-M?-----o--T
oEM----TX---o------|E-?-T--TX-E--B-----------?B?o-?--?X-EM---o-E---B---|-EX--o--B--XM-------o-?---?X-?--?-B-?---?-XX?-------oM------X?--E----oM---|----?-M-B--EoMB----M--EB------|---M--?X?------------o
BE-B-M-|-M-o?o-----XE---|-?|?Eo-oE----oX-----------?o----------M--E?---|X--X-?-?-?-E-----B-oE---?X--oo-----T-?X---o----?--------?T----MM---T--oM--X--------?o-?---B-----E-?B----?|----o--------oMo-MBo-X
M-o----|BM---T----MEo---|?-|-o-?--oM-----B---?XX----o-E?--oM------M-XMoX-?-----------M----Mo--ETB?---o---XB|-E-?BM-X--M--X-X-B-X-|-M-E--o-o|-E--?---?-B-BXM----M--BT----T-?--MX--X-B--?oB-----------???v
-----T-X-M-B-|-MX-M-B---|--|--M---o--B--M-T----B---B----X-----EB---X--EMM--B----M------B-M--M?-|--T----o?MMXMM--o?X--X?--------o-X-----E---X----B-oM--o------------X----|X--X?MM----E---?---E-X?---X?B-?
o---E|----o-X|X-M-?E-BX-X--XE-E?X-o-------|------o------o-M--EMo----o--o---B----E------EM----BXXXX|-Xo---o-E------------X-MX-?--o-?T------X-M----B-o----o---oM---M--o---|-B-?---o-MBoM-o--Xo--o-EE------
T----X-X---oBXEX----BE?B---MoB---MM-ToXXMB|XT-EM------BMM--B--o----Mo----oX--E-EM--BB-M-?oM--EEM--X---?---E--o-o-B--M------------o-X?----oo?---oXM----XX-?----?--------X|-E----E-------?----?o--o-o-M-EE
|XM--BB---?-------T--?ET-E------?B--|B-B--|-|-----T---?-----XM-----o------T-o-----B-------B---B---M----TB-------------------B----M---E---M--?T?----X-B--B------E--------X-E--------------o-------EE---TM
---E-----------T-X|---M|M---EB------X----MX-XX----|------E---T------------|--B---??-----ME----?-----X--|------?--M----?----------B-----oEMMX-|T------T-----T-T---------B---------------------X--T-----||
---T?----------|--|-B--|--------------------------|-X-----T-T|--------T-X-|---------------E--T-EB-----o|-T--------------------T----------EM--||X---T-|----?|-|X-----B--?---T--------TE?T-----M--|--B--|X
m-T|-T--------T|-T|--TT|TTT----T--T--T------------|---T---|-||T----T--|T--|--T-T-------T--T--|---------|-|--------------------|-------------T||----|-|-----|-|-------T---T-|--------|--|T-------|-----|T
XXXXXXXXXXXXXXXXXXXXXXXXXXXXXXXXXXXXXXXXXXXXXXXXXXXXXXXXXXXXXXXXXXXXXXXXXXXXXXXXXXXXXXXXXXXXXXXXXXXXXXXXXXXXXXXXXXXXXXXXXXXXXXXXXXXXXXXXXXXXXXXXXXXXXXXXXXXXXXXXXXXXXXXXXXXXXXXXXXXXXXXXXXXXXXXXXXXXXXXX
