BMX---?X-B-?----MX?-E-B-??-Eo?oB?MXXoXB-?B-oMB?-BMMo?B?---XM-MM--X--o-B?-?-BB?X-B-B-MXE--?MoM-?---Bo-MX?BX?--??--B---Mo--Mo-B-X-M?EoX-XME-ME-MBM-EXo?---M--o--X---XM?-MoBE?BB-E-?-o-----B-X-E-oM-B-?---B
Eo-M--E-X?M--B--o-oEM----o---B-?oE-BX-oMo-oEoMo-?-----oM--ME?XEBX-MBM-B-M-----EB-MEEoEE-ooo-o---oE?-B-?--EE-oXBEXXo-----X?X---M-E--?--o-----B--M----E-Xo-B-XM------oM--oMoE-X-M----?o?B----B-B-------B-B
?oEXE-M-?ET----o-MBE---o?-XX-EM--Eo--Eo----EMo--X-M-?-o--B-BMB---B--?B-M-BX--?oX?-?EXX-XB-EEE----M--o-X--o?MEEM---E-?--MBE----Xo-ooEM--BBo?EM------EE--oBoBE--EB-M--o-------E--?-?--o--?-o--Eo-E-E-----?
o-------M-|--B-o?X?-T?--M---E--o?X-------o-----oM--------M-E-?-?--X---?B-----X-------------o?E---M-----?---E--?--X----M--B------MBM-M-B-------------EMX---------XB-E-----?---------XXX--M--BM--M------BX
?--M--o-M-X-MM--M--EX-T-------?-----?--M----M?--M--M--o-oo-B--ETo---T------E--Bo---B------------?------o--B----M-E-M-----?-X--MT-----o-E-E--?B--?E--------X---X-M--------ET-----?-----E--o-E??--Xo-EMM-M
-X?B?B-----o--oo--?-?-|-BX-M----X----M-o-?MX-B-Bo-o----o--E----X-oE-X---E---BEE----EoB-ME---M-T---E---E-B--E--E---ME-B-B-------XBooE?---------?----X---?---XM-E----M--E--EX---E-EXM------o-?-EM---E-----
XB-?--M-X-EB-T--E--M-X|T--Xo----M-EMX---EE--o--E-MT--ME?----M-EE?--------E--B--XMEB-----E-X-?-|--MM--X---EM---?BE-----X-?-B-------E-B-oE--?o--?-?---E--MM-oT--?-?BE-----?--o-M---E----o----B-TB---?X---?
--E----?--oE-|B---oM--|X-o--E---M-EMo--o--XM---BBMX-----E-B--E----BMoEX-oBo----o-----TB---EM-MXTE----E----E--M-?-?o-B-----E--EB---M-?---------E----M-M--T??|--?-M--?-oo--o----o--oE?----oB---|------B-Xv
---------X--B|--T-?-EEX---B-B----B---M---o--------??X-E-?Xo?-------ooo-To--oM--E-?T--XM---M--B-|-?----oE?-E---o-----------oB?-EB---X?----------B-M---B-B|--X--------X-?B---------M-B---------X??--B---BB
M--?-----EB--|--X------E-E----B--------B---XMXB--Bo-BB--o--Mo----??----|--M----o--Xo-o----ME-M-|E---?--B-----B-M-M---E-XB--E---M------B--E--XE----M----o|-E--oE---o----o---X--M--------M------B?X---B-?X
E?E---B-----XX-----o?-BMXE----EX-----?--MX?-E---E-E?-MM?--XE-E--MBM--X-X-B-----?-------MEoBE---X-o?-oM---------o?--EM--M-----X-M--TM--oE-o-oE---o-------|M-M-oooTo----E-X-----E----X?------o-?BB-TX--oo-
M--X------------??--------TX---BB--MX--------X--T----BT-M----???---------?--MB--oM------Bo--E--E------B-EBB------X?-----o--------MX---------EM-T----T---X----T-M|M-o-----M--X--M------XE---------|-T-E-X
?---?B-----------M--T---T-|-------o--o----M-----X---?-X------T------B--X--X-B-----M-M----------?----?-----Eo--M---o------Eo--M--------TB---T?--|--X-|--To-M--|--X-E--ET--o----------BE-----------XB|B--o
oM-------------T----|-T-|-|--------------E---TE--E-T---------|-MTT--B--------T-T----------------------------------------o-------------|T---|---|-TE-|T-|-----|T--T----|TT-E-------------------T----|---|
m-----------T--|--T-|-|-|T|T----TT----------T|-----|-T-------|--||-----T-----|-|-------------------------T----------------------T-----||---|---|-|--||-|--T--||--|----|||--T------------------|----|--To
XXXXXXXXXXXXXXXXXXXXXXXXXXXXXXXXXXXXXXXXXXXXXXXXXXXXXXXXXXXXXXXXXXXXXXXXXXXXXXXXXXXXXXXXXXXXXXXXXXXXXXXXXXXXXXXXXXXXXXXXXXXXXXXXXXXXXXXXXXXXXXXXXXXXXXXXXXXXXXXXXXXXXXXXXXXXXXXXXXXXXXXXXXXXXXXXXXXXXXXX
