B?ooo?o?-X---XM?XX-E?o-X?X--MBEo--Mo----E-BBE-MMXB?---o--B?-BB-?EX-?MMM--XB--oMM-?oM--??-BoX-oo-o-oEXoX-XXoEBM?-o--B??M-XEE--?-oMMM?-oX--XoX-E-E?-MMMX-XXB-E-oM?BT?XMoX-EEoo-E--XE--?X---o--EMo?oo--o?-E
EXEoBE-MBEB--BBo-----X-BBXBXMo-B-E?Boo-XXB-BE-EXM--ME-EoEXM---?-MM-oX--B-oB----M--o-B-??B-Boo--T?M?o--B----?-X?Xoo-o?-XB?Xo-E---M--EMM--??--E?EB?-o--o-?B---oXBoX|X?BM--M---B--BBME-?BEB-o-o-?MX-Xo--B?|
X-?--M-XEM--XEB-EBXo-E?--B?---?-XX---X-M-oB--Mo-MMo-M--M--E--E-X--M----X--E--o-M-X-??--X?---?-X|-XX?-XMM--B-?-EM-o----BE--MB-X?XEo--Eo-??--X-B-T-o--XEE---o-E-M--|-M---M---o-X--MBE?MB---X--X-EEM-BXMoMX
?B----B-o---X-X---B-------B----------M-----------E--M-BMXBBT--o-----E----B-B--T?----o-E--E?----|?---?-B---B-M---B----EB-B?--M---?----MXo--o---B|----E?-------M-Mo|--B--M-?-MB--M-----X----oME-o-------oM
?-B?X----M--?-B---M-----EM?-------B---XM-?X-EXE-E--oMM-E-o-|T??oX-X---TTXo---oXE-X--o---M--?M--|T--M---oB-M-----T-M---oXBE--MT?---MX------B---B|-?-T-o--EoM--M---X------BM---?-B------B----oB--o?------B
o-?---E---X---B--------?-B--?o----------B--M--E-o---B---XB-X|--?------||E-------X--MoEB---M-E--X|-M---------EM--X----X----oX-|---------BT--?-BB|---|---M------M?M--o-------M----M?EB--E-oM------M--?---o
?---E-o-----M--M---XM--?M--T--M-X?-M--?-?--M--M-oEE----TB---X-o-?----B||TE--BM--EE--M-----------XMoMM--?Mo---M--------E-M---XX?--X--B-X-|---EB-X-Xo|---------X--E-X---E--?------------E-B-X-------X--?-B
M--?-------E--o---BoM---oX-X-M--T-M------?-?o-E---M--M-|---E---?--E-?-XX|--E--o----M--B-----X--X-M-B-----M------E---TX---oE?-----o-M-?o-X--M-E?----|-o-Eo-----o-o-E-X?----M-----M----Mo-o--BB------?---v
oB----XB-?-----?--MEEE---B--X---|-M----?----E--?o---E--|o-----?B??--o?--|-M---?M--------E-oo?---------oBE---XM---B-TXE-M---B----o-BEM-E-o------X--BXMB-----B-oB----M?-------o---MB--X---MX----B-?-BE---o
B--o----M-?----o--?-B-?To----E--|o-M-EE--oo--M-----E-XXX---X--E--------MX----?M-----?-------oXo-E----o-M------E---B|-B--------EEET------EB--M---E-----XM------B-M---B-------B-?--------B------E------B-T
o----?--------B-----E?-X---XM---|-o?---X-B----X-X---------B--o----?B----------M-M-B-EX-E------EM---B---?M----E----o|----MEX--BB-BX-E------M-M-E--?X-X-B--XB-B---M-E----X--oXM-----M---?M?B---oB---?-??Mo
M-B---o-----?--o-X-?B-X-X----E--X-----X---?T---------o-----------?--------B-EB----E-T-------------BB---EoMB-----E--X--X?--------oBE-M----EEX-T---B--?-----B------M-?----XT--B--M------T-------E-E-T--T-o
--?E------E---Mo---------X------EX---T---??|---------?o--?-------BT-o-?----oT-o----X|oB----T--X---E---B-----?--------------E------------X-T--|--M?-?-M-----oT------------|E----E------|-----------|--|-M
B--------------------T--T----B--B--T-|EM---|------ET--E-----------|TT---T-T-|--ET---|---T?-|------T--T--M--T--T--E----------------------T-|--|----oT-----T--|----T---o---|---------M--|-----------|--|-o
m---TT----T------T--T|--|----------|-|-----|-------|---------T---T|||-T-|-|-|---|---|---|-T|T-----|--|-T---|--|--------------------TT---|-|--|--T--|-----|--|---T|-------|-----T------|-----T-T---|--|-?
XXXXXXXXXXXXXXXXXXXXXXXXXXXXXXXXXXXXXXXXXXXXXXXXXXXXXXXXXXXXXXXXXXXXXXXXXXXXXXXXXXXXXXXXXXXXXXXXXXXXXXXXXXXXXXXXXXXXXXXXXXXXXXXXXXXXXXXXXXXXXXXXXXXXXXXXXXXXXXXXXXXXXXXXXXXXXXXXXXXXXXXXXXXXXXXXXXXXXXXX
