----------------------------------------------------------------------------------o-------------------------------------?-----------o----------------------X------------------E--------------------X-X--
----------------------M--------------?-------------o------------E----------------------------------------------------o-M------------------------------------X--------M-------E---------X---------?---o--
--------------X---------------------------E-X--EE--------------------------------------------------------------------------------------o-o-------------------X-------------------------------------X----
-------------------------------------X----------X-----------------------------------------------------------------M----X----B--------------------E----------X------E---------------------------------T--
---------------------------?------------------Xo--------------o-------MB-----------X---------B-----X---?----------------?--------------------------------------------------?-------------------------|--
-----X---X------------------------X----------M-----------------------o--------M----E---------------------------------------------------------M------------B-----?----------------------?-------------|--
---------X?-----------------------------------------------------------------X-----------------------------------o-------------------------------------------------------------------------------?----|--
-o---X--------MX---------X--B-----------------------------------------------?--Bo--------------------------o---o---------E-------EX-------------------B-B---E--------------------------B-------------XXv
-------------o----------------E------M-----M--------------------------------X------------------------------------------M---XX------------------------------?-------------M---------------------M----B--f
----------E---------------------------------------------X----E-------X------X--B------------------------------------------o-?----XMB------B--------M-------------------------------------?-----------X-f
----------------------------------------------------------------------------X------------B--------------T------------------?-------?-----------------------?-------------------------------------------f
---------?------------------------M-----------T---T------?--------------------------------------?-------XX---------X-----------------------------------------------------------------T---T-------------f
-------------?----------X---------M-----------|---|-----------------------------T------X----------------------------B------------------------T------------------M------o-T-----------|---|-------------f
----------------------------------------------|---|--------o-------T------------|---------T-----------------------------------T---------T----|-?----------T--------------|-----------|---|B---T------X-f
m----------T-----T--------------------------TT|---|----------------|------T-----|-----T---|-----------------------------T-----|T---T----|----|---------T--|--------------|-----------|---|----|--------f
XXXXXXXXXXXXXXXXXXXXXXXXXXXXXXXXXXXXXXXXXXXXXXXXXXXXXXXXXXXXXXXXXXXXXXXXXXXXXXXXXXXXXXXXXXXXXXXXXXXXXXXXXXXXXXXXXXXXXXXXXXXXXXXXXXXXXXXXXXXXXXXXXXXXXXXXXXXXXXXXXXXXXXXXXXXXXXXXXXXXXXXXXXXXXXXXXXXXXXXX
