---------------------------------------------------o-----------------------o--------------------------------------------------------X-----------------------XM-----------------E---------------------X--
----------X----------?----------------X-XB---------o-----------------------M-----B---E-o--------?------------------?---------------------------------------B-B----M-----------------------?---------X---
----------------------M------------------?----------E--B------E---------X-----------------------------------------E--B-------------------------------------------E-------------------------------B------
----------------------------------------------------------B-----?------------------M---------------------------------------------------X-------------------------B-----------------------------o-?------
---------------X---------o------------------M------------E--------------------------------B-----o----------------------------------------------------o----B---------------B------------------------M----
----------------------------------------------------------B------------X---------B----------X--------------------------------------------XXX-----------------------------B------------------------------
-------------X---------M-----------------------------------------------------------------------------------------o-----------X----------X-------------E-----E-X-----------------------------------------
-----------?--M-------------B----------o---------------E----X--M-------------------------------------------------------?---------------X-------------------------B-------------------------------------v
-----------M-----------?--------------------------------------------------X---------B--o--------------M----------M--------o-----?------?---------o----------?------B-?---------------------------o-----f
----X-----------------------------E---------------------------------------------------E---------XM----------------?--------------------?--------------------M----------B?--------------------?---------f
-----oX-------------------------------------------------------?----------------------------------------------------------------------o-----------------------------------------------------------------f
----?-------o---------------------------------oT----------------------------------------------------------X------------------------------T-------------------------------------------------------------f
-----------------------------------------------|---------------------T------------M-----------E-----------?-Xo------------?E-------------|------T-------E------------M------T----------X----?----------f
------?--------------------------M-------------|---------------------|-----------T-----------T-----------T-----M--------E------T---------|------|--o------------------------|-----T-T------------------f
m----------------------------------------TT----|---------------------|-----T----T|------T----|-----------|-----T---------------|--------T|------|----------T--------------T-|-----|-|------------------f
XXXXXXXXXXXXXXXXXXXXXXXXXXXXXXXXXXXXXXXXXXXXXXXXXXXXXXXXXXXXXXXXXXXXXXXXXXXXXXXXXXXXXXXXXXXXXXXXXXXXXXXXXXXXXXXXXXXXXXXXXXXXXXXXXXXXXXXXXXXXXXXXXXXXXXXXXXXXXXXXXXXXXXXXXXXXXXXXXXXXXXXXXXXXXXXXXXXXXXXX
