XXB----o-EBXBME--BBBE-oB-Eo--o-?X---o-BBE---X-?--MME---M-X-BBX--E--?BEEEME---ooB---?E--o--EX-o-?X?oXMMBE-M-XoBXXo?XB?MEBMEXo-E---XB-MB--BBBB--o-E?XM-XoM--B---EBX---BoX--MM-oTBBB---?E--E-?oEEE--Xo--EM|
-M-X-?BMEETEo-?BooBX?-BX--ME-oMEoX-o-MXB--BM--MBM?--?-E--X-?--?E---BM-?-BMo--Bo--EoM-?--o?-XEB---M-XE--E--oBXXo--M-?--E-BooM-E-X-E-----EM----?---?EEX-B--o-------?M?E-EX-EBE-|BB-o---EM?--?B---BM-X-X---
o-M-MEo---|-oX-E-o--M----XTE-B-?o--o----B--XEM-----BM??----E-oE-Eo--X-X-BE-?-MX?---?---ME--?-ooEE-Mo--------?oXB--oEXEE-?--oXM--?M-?ME---X----M-?----?---E-----M-M-X--XB?EoEE|M---B?-------?--E-------Mo
----T-----|X--M-M---------|--M-X-MM---o--------?---T----------?--o--------o--o-E----E--B---------M-B--E--XX--T-X----o-XE-B-o--X-o?-------X----?---?--B-MXE--TB-EM-------E----|--E--o-E?oE---?----E-XB-Bo
X---XM---o|-T----X?-?---o-Xo---------------M-------X-----E----?------------B--MM---T-----M-----------Bo----M-|?-B-?-------X--X-------?-T-o---o-----M--X---M-X-X-M-------o?---X----E--o-oo-oM---oM---MTTM
X--?-E--B-X-X---X-----M--------T------oT-oE-M------------M-Bo?o---Eo------B-X-o--ooX-BBM------X-B-XB------M-EX--o-?------o--?--------o-X-M-----M-?----------EE-E--?B-T-Mo----E------------?----M--?-B||E
B---B-E-o----------------X-----X-B----B|----------?-Bo--------?--B-----------B--E--B-----oE---T----?T---M------T----?-M-M-----T-oT--?---E-----MB?-----??-------M-?--?|--o-----o-Xo----B----oMX-------||o
o--o-----X----X-E-M-M--M------M----M---X?------------ME--T----E---o-B------ooB-B-E-----?-TM---|--E-E|--X-----T-|-o----o--o----|M-|---MM----------T----BE---B-----?-TM|o--E-B-----B--T-?---oo-o---EM-M|-v
|---?--BB---?XM--o---E--X------EMMo--X--------BX--?------|?--M-E-----E-ooM--o?--MMo------XB---X---T-|------B-X-|-T----E-------|--Xo-------E?-----X-M-------------?B|-|---oo---------|------E----T---E-XM
M-?-----E--Bo--E---E-----M---E-M---o---o?------?-X?----?o|-M?BM--X-?EM-oE?-BM---M?--o-----B?X--XM-X-|X-?M-X?M--|?X?------B----X-----E----o?-X---E--o----?------X---XBX--E-----B-T-?o|BE--M---X-X|B---X-E
o-B-??-M-----M--o-o-Bo------?ME-E------MB-----M-oB-o-----|X-------?E?-----BM---------E--B?--?--M?---XM?B--B?-oEX?M------B--E----TT--E---B-B-EE--B--o------Mo--E--X--ME-E--------X-MBX---?-M-E---XoM-?-oB
T--T-------------T--------T------------T-----------E-B---X------T-------B?------?-M--T-----------T-----oE---T----M--o-B?-B?-----XX---------?--------------?--M-----------------------B----------?--T-BT|
|--|-----------?-|-----T--|TE--T-------|-T---------------?-----T|-------B------------|T--T-----T-|-----E----|----T-X-----B-------T----------o-M--------M--T----E--T------B----T--------B-----------|--|X
E--|-----------T-|--T-T|--||-T-|-T----T|-|-----T-------T----T-T||----------------T---||--X--T-T|-|-T--------|----|--T------------|T---T--T-------------T--|-------|---M-----T-|-T-----------TT----T|--|o
m--|-TT--TTT-T-|T|TT|-||-T||-|T|T|----||-|--TTT|-T-T-T-|--TT|-|||--TT-T-T---TT-TT|T--||-T---|T||T|-|T---TT--|-T--|T-|TT-TT-T-T-T-||--T|--|T-T---T---T-T|T-|----T-T|--T-T-T--|-|-|T--------TT||TTTT||--||
XXXXXXXXXXXXXXXXXXXXXXXXXXXXXXXXXXXXXXXXXXXXXXXXXXXXXXXXXXXXXXXXXXXXXXXXXXXXXXXXXXXXXXXXXXXXXXXXXXXXXXXXXXXXXXXXXXXXXXXXXXXXXXXXXXXXXXXXXXXXXXXXXXXXXXXXXXXXXXXXXXXXXXXXXXXXXXXXXXXXXXXXXXXXXXXXXXXXXXXX
