---------------------?---------------------------------------------E-?-----------o------B-M-------------XX-----------E-----------E------------------o-----------------------------B----X--X-------------
--XE----------------------------------------------------------------E------------------o-------------------------------------------------------------X--------------------------------------------------
-----------------XX--------------------------------------------------X----B------------------------------------------------------------------M-------o----B--------E-MX--M---------------------------X--
------------------------------------------------------------------------------------?--------?--------------------------------------------------E----------------------------------------------------X--
-------X--------------------------------------------------------------B---------------------------------E----------------------------XX------------BX------------------------------------XX--E----------
------o-----------------------?----------oX--------------------------?-----------------------------------?------------------------------------------M-------?----------o---------------M--M--------X----
-----------------E--------------------B------------?----M--------------o----------------------------X-----E-----------------------------------?------------E------------------------X-------------------
-----------------?---------------------o---------------------X------------------X-------------------------------------?--------------?----------------X----------------------------?-------------------v
----------M-----------------------------?------B----------------------------------E--------------------------------------B------------?---------------------------------------B-----------X------------f
--X----E---------------------------------------o----------------------X------------------------------?-----------------------------------------------------X------------------------------B----------X-f
----------------------------------------------------X---------------------------------B----------------------------------------M--------------------------------------------------------?-----B--------f
-----------------------B-B--------------------B--E--T-----------T--M-----------------T-----------------------------------------------------------------------------------------?-----------------------f
---XB-------------E-----------------------------?-M-|-----------|-B------------------|---------E----B-T---------------------------------T-----------------M--------T--------------------T--------------f
----------------------------------------------------|-----------|----------T---------|----------------|--------MM--------------------T--|--------?-----T----------?|--------------------|------------B-f
m---------------------------------------------------|-----------|----------|---------|----------T-----|--------------T-----------T---|--|-------T------|---T------T|--------------------|-------------Tf
XXXXXXXXXXXXXXXXXXXXXXXXXXXXXXXXXXXXXXXXXXXXXXXXXXXXXXXXXXXXXXXXXXXXXXXXXXXXXXXXXXXXXXXXXXXXXXXXXXXXXXXXXXXXXXXXXXXXXXXXXXXXXXXXXXXXXXXXXXXXXXXXXXXXXXXXXXXXXXXXXXXXXXXXXXXXXXXXXXXXXXXXXXXXXXXXXXXXXXXX
