EBoBB-E?BXEo-X?-?--?---ooXM--?---?EBX-?B?XMMEMMBXXX-oXB?oBM?MMMoMXBEMM-?----Mo-----?EX-?Eoo-?X-BXX-EME?-X-X-?--MoBBE--??oBoM?-MB-?MX?X-?o--Bo--XXoM??---B----EM--MM?E-B-?-EMEBEoX-X-BE----Mo?---Eo?-X--E
T-oo---M-Eo?oo-B-?--M-M---B--o----EM?M--BXX--oEXEoo-EE--E-MM--BXEoE?B---oXB-B--Eo-oM---?----B-oXX-Eo-M--BXoo-X-?-T-o--ME-oM--X-----ME-BE-M?EX--MXM---M--M?BXo-M-BoE--BoMBXB--M?E-X-B--XXE-X-??XEo-EM----
BBoM--XB-?-ooMB--X-M?-?B-X-X-o-E-X-ME---BBBX--XEXo-X--o-X----X------MM-B-E---M-E--M-B-?M?o-ME-XEX?B---------?--X-|-?--X----?oE--E------E-?M-T-o-?-X-EEo---?BBX---?--MX-B-BE-M-M-MoM----?E-BMooEX--X-o-?M
Mo---X-MM---------o-oo-M--T--------E----E??-X-E----X-----B---?--E-----M-----X--------oX---BBEM--oE-o--BM-------X-|-T----B--oM----B--XMMB---M|E-------------oX--XEB?-B-BM-T--B-B---?-M?---BM-------B--X-M
---------o--?-M--B?T--E?E-X---B-----?M--E---------M-?-MM---?oB---M--Eo-X-o--?---T-B-M----E-----M----E----EEX-----|o|E--o----?B?-X-----B-----|-?-XX-------MX-M----B---M-M-X-----E----EM--??o----M-o-MM--X
XB----------------B|B--MM?-X---EE-?---BB?-------oB--BT-EM-------E--Xo----B----E-|-E----?-M-E------EBo--------?---X-X-MM---B----B-----X----E?T??---B-Bo------------X---X---X--o-BE-BB--o-------M-X-M-----
|------?E-?--oMo-X-X-?-?-?-----MEoMMM-----o---MM-EB-E|-o-XM---o--o---M--E-M--?--X-?---M-X-----X--MoM--X-------------B----X---XMB----M--BT---|M-XoB---M-E-?---B--E---o--Xo---o--EM--B------?----B--EE---E
E--M--T----------M--M------B--E--oB-?-B--X-o-X-o-----X--ME---M--?---M----E-X--T----B-oo---X-oE-M--M-----X---oEM-?---Bo-------B-------???X--o|EXMMB----BEE----MooE---------o-Mo------o--B---M---E-TE----v
------X---o-----M----EX-?M--o?-B---oB--MX---------B----B-M------?-?T------B---|----M---B----?-----B--Eo---X-o---oM--BE---E-B-?---ME-----o--?|---oE-?oo----o----E----?--------------X--X--?-------|-----T
X----?-oE-----B-?-M-EBT-------o-B-TBM---MM-----M----EB?M---B--BE---X-M--B-o-MB|----B--?----TM?----oo------------------E--o---M---BMEXX---B--X--X?--?M-E---oBo-----E--o-----B-Bo----o-E--B-o------|--BB-M
|-E---------B-B---oB?E|M--M--B--E-|?--?-BB------B---?----BB--?--T---?--B--M-E-X-oX---------|Mo-oE--BEo??--?-M---B--------?-------E--M-------M--?--M?----TE-Eoo--B-oEMM------E-?---EM?--EM-TEM--o-|oo-?-T
?-?--------X-------T--X-?-EXEM----|--M------------T----T------??X---E-T--Mo---?X----?-E-T--|----T-----M-EM-EE--X?-B--T-o?o-T-B---B-?T-o---EE--------oT-?|--o-E-oEB------X--X---T-X--T-B-TTXB--B?-XM--?-X
T------T----E-MoM--|--o--T-----?--X----E---X---T--|----|--------Mo---?|--T-M--------?--X|--|---M|----E---------------|-----|-Eo-B---|----M-----------|--X--?----M-----??-------|----|-?-||-------------o
|----TTXT--------T-|-T---X------BME---TT-------|T-|B--T|-----------?--|--|--T-----------|M-T----|--T--X-T---T--------|--o--|------T-|T----T-----T----|-------------X-----------|-o--|T-o||-T---?---T---X
m----||T|-T------|-|-|-T--------------||--T----||-|---||-------TT-----|--|--|-----------|TT|----|--|----|---|--------|-----|------|-||----|-----|----|------TT-T---T-----T--T--|T--T||--||T|--T----|--T|
XXXXXXXXXXXXXXXXXXXXXXXXXXXXXXXXXXXXXXXXXXXXXXXXXXXXXXXXXXXXXXXXXXXXXXXXXXXXXXXXXXXXXXXXXXXXXXXXXXXXXXXXXXXXXXXXXXXXXXXXXXXXXXXXXXXXXXXXXXXXXXXXXXXXXXXXXXXXXXXXXXXXXXXXXXXXXXXXXXXXXXXXXXXXXXXXXXXXXXXX
