---XMMoM-X-XE-X--?EB-B--o---o-o--?o-?oBXB-BMX-XMB-BBoX-E-?---------X--BB-M---EBE-?--M-?MEo-?oB?B-B---XXo--??EB?-oX?E-MM?X--BEEoX-o-E--MXM-Bo--?E-?-MEXo--o-BB-?E?-E--MB----E-----XBE---o?-X?--MoME?BB-XB
X----EBXoEo---?X-E-BX-MXoM?-o--?BB----E-Xo-B?-EX-o-BB?B--M-B-B-Mo-EXEoEo--B--E-M-M-M---oo-X---X-E-oo--o--?---XEM--M-BX?oE?E--E---Mo-?BX---M-B-Bo-o-B--XEo?B-EX---ME-oB---o-MBEE-B--M-?-B-o-M----oM-X?o-M
M-o--EBM--E??-----??o?-?E---?-MX--EX--M-M---o------M-E--oo-E-?-Mo--M-----BMEMo?-o?--MMo?-ME-?oB-?T-?-M-ETEX--M---o?B-M--o?-EB-BEB?E-------MMXX-B--M---BT--?--M-o--?BMB-MBX-o--XoM-?X-oE---X-o---E-MXMo-B
B----E-oBE-o-------------??----------EM--BE----X-----M----X--M-BT------M--o--E-----M--------MEBM-|---B--|Xo--------E-------T-------M------E-B--E-------|-oB-M?MXM---T-----E-B------E-M?----X-------o??-T
M----E-----TT--M-B---E------?--E-?--?---oo----?---EB-EoM----M-EBX-XM----E-------X-X----BB-BM----MX---??-XB-X-------?----M--X--oM-?-M--?---MM----BM----MX?--T-?E-ME-E|-MM--oo-X----B----?-X--T--------MTE
oB------E--|Xo--M--M--------oEE--M---o--MB?---B--E?---E--EM---B--B----ooB--X--?EE?---X----M-ETo-MMB---E----B---T?--------E----?--oX-----X------?-oM----M-M-|---?o---|-----?----oBB-Xo------E|---XX---EXE
|-o-XoBE-T-X--MX-----?M-----?-----E--o-?-BB-X-o-EB-------BEXoX?E----M-?B--------B---M----X-oM|?---T----MM------X?-TE--B-Xo---B----?-M------------------oE?-X?---o-X-|----EBBE---TB-B----MME-X--X-------?
|---o----|X-E-oB-B-oX-----MB-X-------?-T---M--o-oM-o-?---E?T--M--E---?----------M--XE--o----MX?---|M--o--Eo-------|oo---o--TE--X-MM---XBo----T----E?M--To-EM--------X--?----T---|?X-?-------?--M--??-?Ev
E--X-E---X--oo-?ME--o-----M-E--?-----?-XMX-M-?------------o|------B--------?-X--?-E--E----Mo----o-|-?o----------X-|?--B--oo|--o-o--EXE-----T-|--------B|oBB--------T-----B--|---|Eo---X--E----?--o-B-M-B
E------X-o-?----------B--M----------X---???------?T-----?-E|------oX--X--?-o---T?XB---o---o----o--X?-B--B----?ooB-|-B-----M|E-?X??------M-oX-X-X-o---Mo|-----M--M-X|-X--T---|--X|--Mo---M-E-MM-?--Mo?-oo
B--------------?B-M-o-----X--MMBX-M-E-----oBo-EE--X--oM----|-E--------o----M---|-?--M--T-?B-X----Xo-E-o-oX--?--M-MX--E----BX---------X-XE--M?--Bo-o--B-X-X-M-----?E|---E|-E-|o-?X-?BM--MB-MM---o-B-T-?-?
T-EM-M------------E----o----M--TM--MM----Bo-B-------TM-E---X---X-----T--ETB-EB-X-?----EX----------oE------M--X---B?M---T--E----MT--B-----?o-M--B------?-X-------Bo-XE---X--?XTTMT-M-B--------TM--T-|-oTX
?--EMX--?--?---------T--------X|-T---B--?-T-------?-|-------------o--|---|?-T---To------------MT-----M-XX-----T-------T|B-E-----|--M--------------o------------o---T--X---E--||-X--------B---|---|-X--|?
B-o-T--o-------------|---------|-|--?-----|T--------|-----T--------T-|--T|T-|---|------T-------|-----?-----T--|-T-----||-T---?--|T---------------------------XX----|EE--T----||-----------T--|---|----|X
m---|-----T--------T-|---------|-|--T-----||--------|-T---|-----T-T|-|--|||-|TT-|--T---|-------|----T---T--|--|T|-----||-|-T----||-----TT---T---T------T-----------|T---|----||T----T-----|T-|---|----|-
XXXXXXXXXXXXXXXXXXXXXXXXXXXXXXXXXXXXXXXXXXXXXXXXXXXXXXXXXXXXXXXXXXXXXXXXXXXXXXXXXXXXXXXXXXXXXXXXXXXXXXXXXXXXXXXXXXXXXXXXXXXXXXXXXXXXXXXXXXXXXXXXXXXXXXXXXXXXXXXXXXXXXXXXXXXXXXXXXXXXXXXXXXXXXXXXXXXXXXXX
