------E---------o-------------------------------------------------------------------------------------------------------------X-------------------------------E----------------X------------------o-----
---------------------------------------------------------------------?---------?---E-------------M-----------------------------------------o---M---------------------------Bo--B---------------------X--
-----------------------------?--------------------------------------B----------------?-----------------------------------?--------------------------------------------------------------------E---------
-------------------------------E-------o--------------------------------------------------------------------o---------------------------------------------------------------------o----------B------X---
---o------------------M-------------------B----------------X---------------E----------------------------------------------M------------------E---------X------------------------------------------------
----M---------------o----E------o------------------------------------------------------------------------------------------------------?------------------------------------------------------M---------
------------------------------------------------------------------------------B---?-M-----------------E--------------------o------------------------------------------------------X---------------------
--------------------------B--------------------B------------------------------?--------------------------------B------------EX--E------------------X------------------------?--------------------------v
-----------------------?-------------------------------------------------------------------------------------------------M------B--------------------------------------------------------------------T-f
----------------------------B-X-----------------------------------------------------X------------------X-----------T----------E-------------------------?--------------M--------M--------------------X-f
-------B-----------------------------------------------------------------------o-----------------------------------X---------------------T-o----------------------------------T------------B--------X--f
--------------------------o-------------------------------------------------------XX--------------------------------------------?--------|---------------------------?--------|------------------------f
-------------------------------------------?------------?----o----E-------o----------------T----?---------------------------------o------|------------------------------------|---------------X--------f
-----------------------?--------X--X--------------X----------------------------------------|----------------------------T----------------|X-----------------------------------|--------------------?---f
m-------------?-X---X------------X-Bo------------o--X-X----X------M--------------X--------BX-X--X----o--------------X---X----------X-----X-------B----------B-------------X--XX--X-----X---------------f
XXXXXXXXXXXXXXXXXXXXXXXXXXXXXXXXXXXXXXXXXXXXXXXXXXXXXXXXXXXXXXXXXXXXXXXXXXXXXXXXXXXXXXXXXXXXXXXXXXXXXXXXXXXXXXXXXXXXXXXXXXXXXXXXXXXXXXXXXXXXXXXXXXXXXXXXXXXXXXXXXXXXXXXXXXXXXXXXXXXXXXXXXXXXXXXXXXXXXXXX
