-------------------XX--------------------------------------------------------------------------------o-------------o------X?--------------------------------------------------B--?----------------------
-------------------------E------------------------------M------X-------B---------M---?X--B-----------B-------------E------?---------------?--------------------E----------------------------------------
---------E---------------------B---E----------------------X--------------------------------------------?-------------M--------------------------X----------B-------o-------------------------------X----
----------------o-----------M---B-o-------------------------B--------------M------o------------o--------------------------------------------------------------------------------------------------------
-----B------------------X-------------X--------------------------------------E-----------------------?-------X------o-------------?-----------XM---------------M----------------------------------X-----
------------------------------------?-----------------------------?----------------------------------o--------------------------------------------------------------------E-o----------?------E---X-----
-----------------E-B---------------------------------------------------------o---------------------------o-----------------o--o------?---------B--------M------------------o-----------------M----B-X---
-------------------------------------B------------------------?----------------------X------------E-------------X-----------------------------------------------oMo----------X-------------------E-----v
----------------------B-B---E-----------M--------------------------------------------------------E-----------?-----------------------------------B-----B----------?--------M--B--------------------o---f
---------------------XB----------------------------------------E-------------------X-----------X---------X-----------------------Bo---------------------X-------------------?------X------X------------f
-----------------------------B-------------------------------?------------------------------------------B--------o---------X---------------B---------------------------------------------------------X-f
---?---------------B--------------------M-T-----------------------------------T-------------------------------------------------------B-------------E--------------------------M------X-------------X--f
------------------------------------------|-------?---------------------------|-------------------------------------------------------------X-E----------o---------T-------------------------------X---f
-X--------------------------------T-------|--TT--------?----------------------|---------------------T--------T----------------------T---T----E-?-------------------|--E------------------o-----------X-f
m---T-----------------T----T------|-------|-T||------------T--------T-T-------|----T----------------|--------|---------------TT-----|-T-|TT------------------------|-----------------------------------f
XXXXXXXXXXXXXXXXXXXXXXXXXXXXXXXXXXXXXXXXXXXXXXXXXXXXXXXXXXXXXXXXXXXXXXXXXXXXXXXXXXXXXXXXXXXXXXXXXXXXXXXXXXXXXXXXXXXXXXXXXXXXXXXXXXXXXXXXXXXXXXXXXXXXXXXXXXXXXXXXXXXXXXXXXXXXXXXXXXXXXXXXXXXXXXXXXXXXXXXX
