-BoM-BoooE----X--X-EBB--?---o-EB-MBE-MoM?E-oM--BE?--MM--MM?BXE--?E--Xo--M--EM-B---o-E?X-Mo?MB?EXXEE-X--BEMBEM--EB-o---XX?MMoBBX-?M--o-M-----EEBoE-B-Eo--??---E?M---B-XE-MMM-E----B-?---EoME-?E--B-?M-?X-
-B-MXE----?EEM-?---E?--X?-M-E?-o-Moo-??MEE-?-X-o?-EM?-B-?B--?-EX-oE-oBB--oE?-?BMMXMo-M--B?-Xoo-oBEBB--XMBMM-ooMB-X--Mo--EB-BE-ME-E--?--XM-XEME-M?B-EEBB-oM-Mo--Bo-EM-XXBEoo?--o?--M-BX-oXMo?-oEXM--X--M-
-X?--oBo-Eo--MBX-----Xo---E--M?M-o-?---?------o-X-?----MM-M-T?o-X-M----B---E-XMXEoMBX-EMo-E-ooBM-EXX-MX-?-B---XX-B--B?o-E---E-X-X---E----o----X---?-B-B?XXo-o?XBMB?B--E----------MMMBE--oo-E--B-XE---?B-
--?------M-M-----B-E--o-M------?B?--B-oM?-B-X-o?-----?X---?X|BX-?--------EM-----?--B---?--B-XE----------M??B-o-E--E--o-M-----B-o---Xo--E---o--B-XM------?-XBB-?E---XB---------E---M--E-M-?-----B?----?o-
---X-?--E-B--XX---M-BX--?-BEB--MM-Eo?--o--B-o-----BoX------oX--o?----E-----------?o--BB-E--oE------EE----?----o?-B---o--X---EB?--------B-oE-X--BM---B---?E-M-M-----?M--Eo-Bo--TB-B---E-----E--BE--BX----
-Eo-X----E--X--B-MBM----?--M--T--B-----B------?--------o-----EE-E?B------E--------B----M--B-E-o-?-E-oB------E-EM-oB-----E-----------?M-oXo---M-o--M------BXB-o---XEo-E----oM-o|----B?----o-?BXM--X?-----
---o-------XM-B--o-M-----B-?M-|E-------?--?------MX--E?E-EX-E-?------?-MM----B--B-B---X-BE-B-X----B-E---M----B--o-----------M?B-Moo----?------?oB---o--o----?--M-EMo------M---X---MB--B-----?-------MoB-
---?--------?--XBM--Mo---B----|M--------XX----M---M-oM----o---?--?oX?--E--XE---B----XE-B-ooE---M--?X--oB--B-MM-oE----MEMMM------E-BE-----?o---BM-B----M?--X-B-----B---oME------M-B---MEB-B-M-??MB--?--ov
-----?B-?-?------M-B-M-----MBMX-----------MX-Xo?--EE----BE?---o--EM?---------o?-M--o-E------E-Bo--M--B-?-TMoB--E--o-XEM-E-X-MX--MX-oE-X----X-X----?--------o--B?--E-oX-M---?-X-----B-?-E----XE-B-XX----f
--??--B?-XMBM---M-X-B---B--MM---B----?----o-----o-EMM-oEM--XX----o--?------------------M?---B?BBB--BX---MXE-o-XoX-?E-o-B-------?--E--E-Mo-E-?MX?-BE-----E--?-----------M---Bo---T?-B-B---E---------?---f
-?------Xo?--X--M-?o-----ET---M-M-E----M----oM-----?-E-o-----B-?--E-oMXoX------------------M--M--XBE---M-MB-MM-M---M----B-?XE--?E-B----------oEBX-B-----M--EXMM------B---X-?---M|-oB------o-BMo----TB--f
-EB--------M--?--------oBMXB--E---EE-B---M--?---MM----?----MXE-?----B-oT?E-------EX-??o-T--EXo----M-oETB-M--------oo--?--Mo?MB-B--E--?--o--E?--?E----E-oMB---E--o----B--M-oB----X-B-------E--o--oXT|M-?f
-o-------BX-?---E?-M-E--ooM-T-E?-----B--To---M-?To-----Bo--------o-M--M|M--------B-Eo---|--------E-?--|E-----BEE-o---M--?MEEo--M?X-----o--BM?T----?--oM-EMX--------M-MB--M-----M--BoXo-o-------EE-||B-Mf
-----------------B-o-----??-|-B--?---B-B|--M-o--|?---X-M-?--B------BB--|--B--E-E-o-o-M--|-----------o-|MX--E---B---TM----------------E----?-B|-------?-??-B-o?-E---EE--E----BB----------------E-B-|X-?Mf
m---------------------------|--T------T-|-------|--------T-------------|-------------T--|T------------|--T------T--|------------T--T---------|----------------------------------------------------|----X
XXXXXXXXXXXXXXXXXXXXXXXXXXXXXXXXXXXXXXXXXXXXXXXXXXXXXXXXXXXXXXXXXXXXXXXXXXXXXXXXXXXXXXXXXXXXXXXXXXXXXXXXXXXXXXXXXXXXXXXXXXXXXXXXXXXXXXXXXXXXXXXXXXXXXXXXXXXXXXXXXXXXXXXXXXXXXXXXXXXXXXXXXXXXXXXXXXXXXXXX
