XX--o---X-ooo-o--M----?M-E?-M-XX-BoE--B-B-EEo--o-EB-EB--X-EM-?-?M---E-BE---M??o-----B--B?oEX-oE-XE--?-BB-?--X?-BE---EB-E-o--M-----M---MBT?MM?-----?XE--?oE-o-o?--M-XM--EBE---E?-EXX?---??M-XE?---o-E-BoM
T-EoM---BMB-XEEo-X--E-BXB-BX--XXBE-?--Xoo---o-o--o-B--BM-MB-E-ME-B--BBoo---M?MMXB-oMBXME-MX-oE-?XBEo-??o-?-MEBo--?-oB-X---oX-o-B-B----oB|oo-XX-X-E-?-oMBE?BME---oB-?E-EoBo-E-------Bo-XB?-X--M--X-B---Bo
X-BE---T-M-E-----E?-?-B?----oE---?-oX-------B-XM-X--??XE?-B-MM--E----?X-----oM--X--BE-X-----o-E---EE-B-----TE-??M-o-X-B-M--------oBB--??|o-B-?---M-M-?-----?-??-EMo---E--Xo?---?-oo--BM-B-----E-?o---B-B
X---EE-|--------M-----M----B-M--o----T-MM-T--E--?M-----BoB-----X?-B------E---X--M-E----------E-----B-------|-----EBME-B--------EXE---?--|X-o-----BE--o------XBo--X-----BB--------T-?-X?-?------M--Bo-MXT
X---T--XE-B--To-oo---?----------E-B--X---oX-ME---------------B-?-----------------?-B-E--?-------?--E-------|----?B----oMX---T--------TB-X----------B--?E--T----?MM--X---oM-E?--E-X-----o---X-------B---?
|---|----EE?-X-------o--?------B---E---M----?----B-------o------M?--M----B---B-?o--M-?---?o-ToME-----B--M--|----?o--B---o---X---E---XXMX--o--?------X?-M--XBo-o------T------M--------------oX----------X
|-?-X?------B-Bo---T--?B--E------B-MM-E--B---T-T---X-BB-T----E-------?-X----B---TT---B---E--|-E-B---B--B---X-T-T--B-B-o-----B---------------M---??-----M--BE---T--?-T|M-oTX----Bo---M--X---M--?--XM-?--|
|E-----------?-M--T|-----E--E---?-EE-E-------X-X-------oX----M-E--MX?--B--M---?EX-?-----M--?X-M---M--T---?---X-T-MB----M----B----------BM----?------------B----XE-EB||-XB|-E--?------o------o-----M----v
T?-B----?-?M---o-TX|o--------?EE---E?T-M-B----X-------EBB--o-?----M-----------B-EX-T---BB?M--E-B-----X-EE--?M--X-?-------X----oB--o--MEE-T---M-TBET?---o----------o-||-M-X-----o----?-B?BB---X---MM-M--T
XE---------Eo-o--|-X-------T-BoT-----X--?---EB-----X-T---?----M----M-?-?-XE-------EX---?T---o-B--M-------B----MBM---M-E--E-T-B-E---Mo----X-E---X---?o-----o---?-X---|XX--B--?--M-----------M?o----?---BE
-M-------?---B-o-X---o-----X-BoX--ooo-?X-o-MMB-----o-|-B-T-M-B--E---oM---M-XE--?--MBB-EE|---?-EBM---BB-o-----X?o----M--Eo-EX--B-o---E------M-XE-o-XBBB--oo-----Xo?-EX---B---MB---B-B--Mo-o--oo------B-B?
M-B-------M---XT--T-B----------T-?-----T-T--T----T---X---X-------T-T-E---ooM-X------B-M-X----B-?------------X-----------o-?-?-E-ET----o-------?------BT--?o-------B-----T-B----------M--------M--------o
?-------T------|--|----E-----T-|----B--|-|--|----|-T----T-------T|-X---E---T----o-------------TT----------T------------------T---|-T--T--T--------T--?|----X---BT-------|-------------o----------------E
X-T---T-|-----T|--|----T--T--|-|-------|-|--|----|-|T---|----T--||-TT---T--|T---TT--ETT-------||-----TT---|----------TT---T--|T--|-|T-|--|--MT----|T-E|T-----T-T|--T-T--|----------------T-----X----ToT?
m-|-T-|-|TTT--||--|-T-T|-T|T-|T|------T|-|-T|T---|-||--T|TT--|-T||T||TTT|-T||T--||TT-||--T--T-||-T-T-||---|---T-T-TT-||T--|-T||--|-||-|T-|T--|TT-T||--||T-TTT|T||--|-|--|TT-----TT-----T-|-T-T-T-TTT|-|-
XXXXXXXXXXXXXXXXXXXXXXXXXXXXXXXXXXXXXXXXXXXXXXXXXXXXXXXXXXXXXXXXXXXXXXXXXXXXXXXXXXXXXXXXXXXXXXXXXXXXXXXXXXXXXXXXXXXXXXXXXXXXXXXXXXXXXXXXXXXXXXXXXXXXXXXXXXXXXXXXXXXXXXXXXXXXXXXXXXXXXXXXXXXXXXXXXXXXXXXX
