--B---M-o-?XX-XBM-MMXEEEM?XB-?-M-MX-B--M-EM?o?XM--E-Mo--B---EBoME-BM-M?--E--o-?M?-M?---MX-o--MXB-E-B-B--o---?-M?MMoM--o?-?---?-XE-XMEo-oMoMBoEoB-?B-oB?--B--B---XMM----ME?-E--M----ooo-EEX-E---?EBX-----
XoX--XE--E-XoEE-BXo--?M-B-MXEBM--o-E----B-MB?--XM--EM-BXBEME--BX-oMEXMoB-B-?M??EX-B-B--X?-M-XMB-oEX-X-?--E-E--B-BXM----o-MBE-B-X-XBo--?--B-B--?MM-BB??-oo-E?-M--MX-MXE-M-E---BBBEo--B---BE---Bo?-?-?BM?X
B-B--X--Mo?---MEo-B--MMo-----BX-?XBX-EM-X---BXXMXM-----M-Xo---M-X-M-EM--ME-??-E--E---MB----X-X-o-M--o-MM-MBo-E-o--BT-?-E?---EoE--oB---X--XE?M--M--M-XXEX--?-----oE?XB-EEMEXBB-MoXB-B-?-X-o-----MEM--o-E-
B-BoB------B---B-M--M-o--?-oB?MB-o-XB-M---EX--M-----M-----E--E-E--??-o-----o--?o?--?E---E-------?-E?o-X-?--o---?--M|----XT--EM---?--B-Xo---X---X?B?Mo--------B-o--o--M----EX--BBo----BBB---BXXT-Eo---E-|
EX--B---BE---M-E---T-X-BEEM-B---E---M?-M-X?---M-------?oB------------B-X----X--o-E---X-----MBBE--M-----?B--------E-X-----|-M-M---------------M-----B-?--X---X-???X-Xo-?E-BB---o----X--M--X-M?E|----MM--?
E-BB-?M?B--X--MBE--X--Mo-o--B-?---------E-------B-E-Moo---B--o-?--E-------M--o---??-----EXX---?---o-XB-B--------?-M--X---|oT----?--X-o-oX-M?-MB-B-?-M-?---TB--E---B-----B-?-----------------E--XX--MB--o
BX---?M?--M--E-----M--M-o-------o-o--o----X-BM-B-?-B---EE-----X--oB---M-?---o----B-X--E?M--B-o-E?--E----?E--X---B--o-E-o-|-|BEB---E----E--o--E-------E---B|Eo----E-M-------?EM-oX-----MX-E--M-X--o----EB
E----------------------BoEXXX-T-B--?-------X--------M---BEB?---o-----B-------M--?-M-MX--?--B----?--E---E-?o-?oX---E-XE---X-|--B------M-EMM-B--oM-M--X----BX--B---E--M-----o-T--M-X--?-E---B--B----X--E?v
|--o-EM-BME-----X-M-E----M--?EX------M-XMM----------?---T--EM--o-oMTX--B--E---M--o--E---oEB-MXX-o---B-----ME-E-oE--E-o-----|M-E----?X----MX--------ooB--B-E--?----EX-X----B-X----??-----------MB------MB
M--M--E-B-------BM---X-B--M-E-----X---E?B--------?-?-?--|----T-----Xo---?--X----B--o-E---------E--M--EE?E---E-B-M-X--------X?--BM-E--B--M-MX--?-----oE-M--E-----X----BME-X-?----X---Mo---?-X?o-----Bo-oB
T------EoM-EMo?----EEB----B-E--ooM--E--B---X?E?X-?X?BE--X-B--X---X?-M-----------------XB---Mo----o-----MM--?-MM-?X-M-X-M-----B---X--?E---EE-?E--E-?E-E-------B-B--o------M-?-Xo--XE?---MM-------E-B-EEMX
B--M----T---o-?----TE-XX?--X?--o------oT-X-??-B----o--X----------B-----B-X-oo----X------?---M-------TT------X----B-?T----o-Eo----T?-----------TB-B----M--------B-?-o-----?----M---?--------E-B--E--o---T
B-------|---E------|--To---X--------o--|---?---M----M--------------To-------o--B-------?-BE--B-o----||-----T--------|-T--------M-|T-o-o?------|--TT-T---M?-X--X-----o------o----?---T-----M----?BB---X-T
-T-T-T--|-TT-B-XEX-|--|EE--T---o-T----X|X----o-------------XX-B----|--T----------M---XTT------T-----||----T|-----T-T|T|-------?--||-----------|--||-|--E-TT--------T----B-----------|--E-?---T--?---M-TX
m|-|-|-T|-||-------|--|----|-----|--T-T|TT-T--T-----T--------T-----|--|---T----TT-----||TTT---|---T-||--T-||--T--|-||||---T------||-------T---|--||-|----||-------T|-T-----TT---T---|-TT---T-|--T-----|o
XXXXXXXXXXXXXXXXXXXXXXXXXXXXXXXXXXXXXXXXXXXXXXXXXXXXXXXXXXXXXXXXXXXXXXXXXXXXXXXXXXXXXXXXXXXXXXXXXXXXXXXXXXXXXXXXXXXXXXXXXXXXXXXXXXXXXXXXXXXXXXXXXXXXXXXXXXXXXXXXXXXXXXXXXXXXXXXXXXXXXXXXXXXXXXXXXXXXXXXX
