-X---B-B--BXEoo?-----oo-Bo-?---E?-M-?-------oMXMB-EEB--EM-X--EB--o---EX-XBMXM-M-E--EE----X-oX?XM-MX--EX-?-oB?--Eo--o-----MM??--?oBXEo-XMXooBB---oBBMX-EB-?--X?--X-EX-?---MMM-?B--EoB-X-o---M-B-?BoE-XM-|
oEBoo?E-X----E?o--?---E?E--X-BM-oBM--EEo-XM?M----o----X---oEXEM----XM-E--X--?-EBE-?BXoE-XEM?M-B--E----?--M?-E-MMEBMXB-o-oMB-BXM-?-M--EBoBB-B---?--EBE--MoM--M-X?-X-?-MM-?-B-MB-Xo--B---Mo--B--X---E-MX-|
BEBMM-Eo---?--XoXMo?--XXX--EX-o-X---?-B------M--?X--MX-T---XX?B-X-?--BB--T-M----XT??E-B-?-o--B?----XoMooo---B--B?B--M------o-?---XM??ME-----EEX--?---MMX-?--BMoB--X-------MM?-?oEBE?--X--o--XEo-oMoo-?oo
|-M--o----------E--------M-EX---M---XoE-E--XE----------|-?-o-ooE---oMo---|-------|M?B--------o--B?-----?o-o---B-X----X-MB--M--X--X--B---B-XB-B-X---ooTE-Mo----?X-M--oX--B----XE------M-X-----ME---------
X--oo?---XX--X-B---BB------E-E--B--M-----B--o?T----T--EXB--?-oE--X-Eo----|X-----X|-----M----?--BBo---?o----BB-----M-E--o---M--EX------B---BE-ME------X---------M-MXMMMo---E--------B------X--o----M--BXX
----?--M-MMM-?-B-EEM----E-B---?-?M-MXXT--?Mo--X--E-X------B---------M-M--X--B-?--|oT--X------?BE-oB----BB--o---------MB--B--------------B---------?X--E--MBX---Eo--?-----E-X-------B---------E-o---M--?T
---E---ME-o---X-?o---E---EE--T-BEMB--o|---------------oX-E------o--B-T----?--?E-?X-XE--?o--E--o----B-----XX-E----?oB--Eo-?-o--BXX--E------M-o---M-M-----XM-o---oEX?-------M-o---E--E------o-B--?MXEEX--B
T-?-M---o--?-M----o-o------oXX?---??--|--BB--?-E?-----E------MX------XBB------?EEoB-------EE--E----o----------X--?Mo-----B--X-?-oE----o--------o-X--E--o?-----XoBo---?-?---?-E------o-E-o--------M-E-X-v
o-----BB----X-M--BM-----B---EE----MEX-|-M-?-ooX--oE---M---M-X----E---o---------o--?--M---B----B----o--B----Xo---------B-B-B-BE--o-?------XM----------?-E--B-X-B-?M-B----B-o-E---M----------X----------o?
BX--ooE-----M?--------?-------M--?---B-XT---------E----E?-----E--o--MoX----T---o------------?-------XXB---?-M----T-?--------?--Bo-EoMM--E------M-o-----o-MM??---?-----XB---B-----BEE-oB-BX----------X--T
M-----??--M-----E-B--B--X---o?-Bo--?-oX-XE-E--?-----EM--EBo-?oM----oo----o-|XM--oMM---E---E----EMo--------M--oM-?XE-X-M-BE-----------o---TEEB?o---B-M-----EB---X---BB----M-M--BX-?o--B-o--------Xo--E--?
T-----?---E-?-B-----X--M-X--------X-------B---TX----T--------T----T-oB-?---|--?-o--B-E-------B--MBMT---------T--------BX-E-----T---------|-----B------XTTE--o-E-B----------?MM--TE---B---------o--B----M
E--------E---X------M-T----?-------M----------|T----|-X?-----|?---|----B---|T--------------------T-|------o--|---MM----------M-|-EM------|---T---------||------------M-o--------|---------M---T-------E-
?--X---M--E-----------|--X-o------------------||----|M------o|E---|------X-X|--T--EE--TB---------|-|--------B|----T------------|--------BX-T-|---TM----||--o----MTB----------E--|---?---T-----|T-------T
m--T---T-T---------T--|-----------T-----------||T-T-|--T--T--|T---|---------|--|-----T|-T--------|-|---------|----|---------TT-|---T-------|-|--T|-----||-T--T---|--T-----------|-------|-----||----T--E
XXXXXXXXXXXXXXXXXXXXXXXXXXXXXXXXXXXXXXXXXXXXXXXXXXXXXXXXXXXXXXXXXXXXXXXXXXXXXXXXXXXXXXXXXXXXXXXXXXXXXXXXXXXXXXXXXXXXXXXXXXXXXXXXXXXXXXXXXXXXXXXXXXXXXXXXXXXXXXXXXXXXXXXXXXXXXXXXXXXXXXXXXXXXXXXXXXXXXXXX
