o??EoM-X-X--MMM--XEM?Eo-Eooo-o?Xo-o-B?--o--oE-X----X-MMMM-E-XE-o?--??BooB--EE-?o--XM-BX?M??EM-X?-oMX-oEX-oXEB?-E-BBX----o-E-X-oE-BX?-BMX-M-?-Bo----B-E-?--M---B-X-BE-o?E-XBB-XE?EoB---B?XMM-X--MM-o--o?-
o--oE-Mo-M-oE-?--oX-XBMB-?E--?---B-o?--BEBB?--E--X-oM-?M-BB--E---BEoB-M--E-?--M-?-?-MB--BBEE--MXBoXMEM-B-BMX-M---Bo-E---???E--E??-o-o----o-M-XM---EBoXE-?o----XEM?X--?--X-B?M?--X-X-MX?-MEEMo?oB---M--EB
|------MX--B-EXB?-o?-X--?-XoM--X---EEooB--M-E-?---B---M-?X-Eo-E?X--oB--XX?--o-oM--?-------oo??BB-M?E-?-X-MXo?-?MB-------X-XME-EM?Xo-??EEEB-E-M-?MMMBMo-E---?-o-Bo---E--XM-Xo-o-?B-?E------E??-B-B--X-?MM
|B--B----M-M--oMBE--E-M--M-Eo--?---X--M----------E--?-----B-M-?-----E-E--o--M?----T----o-BX-X------oM-----M---------B?E-?--?-Xoo------oB-?BM---?-M-----?E--M---------XMXo-ME?----M-o-MM---o?-B---?-M----
E--?-----M--------Mo?---E----oB--X-M?------B----M---EX----E--ME---?-M----E-----E--|o-M--XEo------E------------E-----o-----o---EoX---M------oX-----E-?---?B--X?E---B---TMB-?M--X-M?-o-?-?--Eo-E-B--E-o--o
?-?o-----B?--Xo-E--o--MB-X--B---oB---?--M--?-B--E-----XM--E--?--MM-X--TX--oX--Xo--Xo-B-M--?M-XB--E-B-----X-?--MX---E--M---E?--B---o-M-------oE--o?o--Mo--oo----o-?----X-----M---B------------E---Eo-?X-T
ME--B-EB--o-BM-----B--B-o--------M--E---oo-oX----E?--------M---B----EoXE-Bo--B-M-E---oM-oE---?EBX-BMM----oM?B-oME?--BE-X-X-M?--------?---------X--?-Bo---------E-EMM-oM-----oE--EEo?--B-----X----?-E--Xo
M-B-BM--E-M-----------E--XX--o--X-B--M-M--E--M-M----?------oX?-B-?-oM---M-------X-M---------M---M?--o-ME-ME-?X----M--MEE---?-----E---?-X-o-EXXX-BoBo?-BX--B-----MM-E-MBE-T?---EB?-?-MEE------M--XB-T-M-v
B-Eo?BXE------B--B---M-Bo?----E--Bo-oMo-----E-EoM--------?-B-?E--Bo-XX-M-----?-E--E-?--------TBM--M?E-MoE-----M-BMo-o----BM---B---M--EBo----?----ooBoE-?E--o--o-Eo--EBM-MX-XE-o-?E-E--------E-o--M-X-oo|
|---o-EBBEB----oo--?--------XE-X----o--E-----E--M---B----?----?M---M-o--o-----X-X-----Mo?XBX-|--o------M--MB---B---B---?-?-M----M---B?--X----M---------MB----M-M---M--o--B?--X-?-EB-EE--X---?-ETX------T
-?-oo--?-----B--BX--BX-oM-To-?-BE-E---X-E--X--Xo?-B-?-----MXX?E--------B--o-BE-MM--?-o-E--T-E|M-------Bo--?--?-?-E--?E-X----E------?--MMBBME-B--Xo?B--X-------M--MT------B--o?Xo----E--MBBM-?o-|-B--oB-o
EMM-o-?oE---B---B?E-B---M-|o--?------?Eo-----M-?---X--oB---M---BX-?B?---B--M-oX-T--o------|-B|--X----X-o-M--------?M---B--?-------M--X--EEME-----o--E-EMM-?X?-----XB-o--B--X?---?-o----MMB---MXX--XE---E
Eo---M--o-MoM-M-B-EBE--M?-|--B------?M-E??---Mo-MXM---o-B-------?---M-M--?M-E--BXB-oo-EE--|--Xo--B----?EX---Xo-------MBT-E-X-M----?o--XMM---M---X?TM-BE-M?-------o---BT---?-----E-M-?-X----B----E?---B--
oE---?---X-?---o-M-BEB?--E|----------?----MX-o----M--X------E--Boo--M-?-?-----?----M-EB--o|--BT-??--B--E--E-?-X----Mo--Xo--E-?BB-o--B--?-oB-------|---B---B-X-oXE-----|MX--BM-B-E-o-------E-ME--E-X?--ME
mEXX?-o---XM?--o---??--Eo-X-E?XMXEX-X-E?o-E?MM-XBoB--------E-BXE-BXXEB-X--E----XBoME-MEBo-Xo-MXo------?-E--MMEE--X-??oX-?M-E---oXB-oBB-E-E-BX-X---X?-B?E-oBX-X-EMo---?Xo-oX-o--M----E---M-M-B-XE--?--B-|
XXXXXXXXXXXXXXXXXXXXXXXXXXXXXXXXXXXXXXXXXXXXXXXXXXXXXXXXXXXXXXXXXXXXXXXXXXXXXXXXXXXXXXXXXXXXXXXXXXXXXXXXXXXXXXXXXXXXXXXXXXXXXXXXXXXXXXXXXXXXXXXXXXXXXXXXXXXXXXXXXXXXXXXXXXXXXXXXXXXXXXXXXXXXXXXXXXXXXXXX
