BXXoB-XB--o-??Xo-?X-XXXX?o-?-XB?-M?-MB-?oo-?-BXXXoMMo-?---X?XE--?M-M-?oXXEBMMBoM-M--oEEBEXEE---oB-?MMX--oX-X-XEMM-MoX-?-X-Mo------oX-BB-EE-??MEMM-MEEo?-?Moo-EB--XoB--o-??ME--oX--?-oBEoB-o-M-X-EBEMMEMo
E----M--?--Xo?-EE-E--E-oB-BE-MM?X-?oEM-EE---X---?B?-Mo--E?BXo--MX-M-BBEE-X-oEM?--XBX-?-?X-XMo-EE--MMBMoM-?-o---Xo-Bo---o-M?oXo--?-oXBoX-M-?--oE-M--X-o-XM----BE-o--?M-E?B---B-B--M-Eo-E-BM----X-o?--B--o
|EBM---EB?M---E--B?X--XXM---oo?-?B?o?EB---?-BX-M?-X-MBM---XB-?XXBMEoMXX--EB--???XooX-E-BoM-oE-XE?oEE-Bo----??M---BX?--MXBo-?E-?XEB-XB---XB-?o----XMo-M--o--E-MoME-X-Eo--E--XoBEXEo?----?EM-X-o--Eo-B-o-?
o-M-oM-Xo--EXB??-X-?MM----BoB-MBMo-o-X?XBMoMBMMX??oB-XM--B--X--X?X--?X-Eo--M----E?M-E-ooMB-EM?--X-Bo-?oBBo-oXo-?--?-Bo----oB--XMBEM--?ME-o?oBMX-XEMX-o--M-B-XMM?E-BB-XE-?B--X---XoX?X--?EX-XM??EEo--o--|
-o?--E-B--BMM-B-MM---M?M??----XEX-MX--M-oM-o----B--???oX--?BBMB-MEBMBEMEE--X--XE-EXE--EM--o-oEoo?oB-o-EMX--X?-?X-M-M?E?-?-?-BM-E-X----oMB------?-X--EM?BX-X-oBXBEBB-?B-M?-B---??---XM--X-E---oM-BMBBo---
?E-M-EE-B-?E?X-X-X----BBooB?--X---oo---M--BEM-o--Xo--BXMoBo----XEE?-MoEo-M--X--------BMM----M--ooX-X??MoEX-B-M--MBX??E-XMEE-X-EoMM?-X-?-?-E--EM?M---?-B-?----E-EoE-MMMM-M?-BEXBBEEMMXXEo?M-----oo-o-E-Xo
M------E?-?MMo--M--oM-oX-?X?EX-?-XXB-B?---B?-oo?B-XoEo-Eoooo?--oM?M-EEB-?BM-??B--BBEBo-XEo---B--B?-M--?--?B-o--MBB--X-BME-B-?---XoMMB?oBMB---?o--B-B-E-X--?oB?-o-?XB-?M?-X-X-B--E--X?---o-MMM?--XEEo---B
|-M--B-EoMME-B-M-?E----XoBoMEB-M--B-?MMM---?-oo?-M?--?---BoX---???E-M?-o--MX-EB?-X?--??MoXE-o-oX-o-----EM--X-?o-MBEE-M-??o?-EX?-M-o?--XX?XBo-oM?E-M---BM-EBX-B-EXX-?B--o-EB-B--EB?-oMMXMXBoo-oMoo------v
?B--?EBX-X-?-XB---oEBoE----M-XM----BEMX--M?-M--M-MoEEEX-Eo--oM-E-o?-XBB-X-BEMBXXBoMB?o-?-oM--B-?BE-E---oB-?----B-BX-EX-E?MEXXoE??EM?BX?o??B??MXE??--B--E?-M-----EoEM-MB-EBB-EB-B?--B--oMX--Xo?oXBoBMo--|
B---E-E?BEBXMo---EXXE-EXo-M-B-BX-o?Xo?-X---o-?-ME?-----EoMEM-EMX--o--MX-X--X-?-B-?XM-E-o?EM-E--o-M?oM-?-BBEoMX-B-EM?--XXo-EE--MX-?-Bo--E--?--X--MEXE?M-?M-----B-oBX-E--X?M-?BBBM--E??M-ooE-BEMEX-E-?X-M?
E-E?B??E-Eo---oo----B?X-ME-E--BB--EE--B-?XMX--E-BoE?--M--XBoX--MoBME----Mo?EEBE-oMo-B--M?o-M??oX--E?-XBoX---MM----BE--o-XE-XM--M---X--oB--E-?-?E-E?-oXoMM?M-o?-XB-E-o-?MBEEXM-M--XEM-BB-E-M-E---MXEMM-MX
--?B-o-?M-X--X--BB----E-MMX-BX---?-BB--E-?-X-BM-?oE--M--M?----XM?E-M-BXM-EoMEBMo?---B-oB-X?M--X-E-BX?E----MBB-MX?MXMEo?M-ME-E-M-X--oEE-Xo-X--?B?-MBBoM-XX?E----?-E-XB-E----?BE-E-BoBX-M-B--o-M-oXB-ooXEB
|-EoEoo----?-M-B?M-?---M-MBEoMXBEX-BXXM-EX-?ME-M---XMM-XB-MMooEoM-?B----M-B-E--oE-E-?--oBX-B-?-o?-XX?oXM?o?-Bo-XXXM?ooMEXBX-----?ME--X-E?Mo-?--BE-EBM--o-X-XMB?B--oXMBXX---??oBX-X-MEM--XBooBMBo--?-M-B-
MBM??-B-M-----E-oooo-B?EXB-o-B?MBoX?-??--oB-X-E-BBE-B-o---MXMB---B-E?ME----B-EBMXE----MM--EE-B-?-?X-M-?M-oX?M--?EMB?-XE-B-EBoXX-B?XBBX-Xo----X--?oo-?oo-M---?M--MBE--BB?M--M-B--?------B-X-XX-X?X-?----o
mBX?E-XE-XB-B-BBE----B-EoBB??X--E--M-B--?--B-EM--EX?E-B---M??-MMo-Eo-X?M-M-Bo-BM?MX----B-?BoM-B-?-----oEEE?X-M-o---?XMBE-M---o-E-XE?--Mo----MMo----MX-MXXB-?-XM--BM-B-BEM-XEB-E?X-Xo?oBo-E??-ooM-MB--??E
XXXXXXXXXXXXXXXXXXXXXXXXXXXXXXXXXXXXXXXXXXXXXXXXXXXXXXXXXXXXXXXXXXXXXXXXXXXXXXXXXXXXXXXXXXXXXXXXXXXXXXXXXXXXXXXXXXXXXXXXXXXXXXXXXXXXXXXXXXXXXXXXXXXXXXXXXXXXXXXXXXXXXXXXXXXXXXXXXXXXXXXXXXXXXXXXXXXXXXXX
