BooM--MBo-----o-XBEXM-B?--X?X???oE-X-??MB-BXMoXM-XE-X---?X?M?-B--M?-X---E-o-o---X-XX?XEE-?MBM-MXM-Eo?--?BB-oXoM-MM--?o?-?-??BBB--BB-B-oEB?-X-M?o---B-B??BEo?BMoEEXMMX-?--o----EEX??E-E-oB--o-?oB?B-E-oo|
E-EB?E--BEXXX-E--X---XBoMMo-MEM-MBo-E-?M-XXMX--BX--B?oo-oEX?o-Mo--BoB-?-X-X?oX-M?MM?M--?X----oM?--?M-B-XBBM--BX---?BE??X--B-o----M-Bo?BEE?-----Eo-BBX-X-BBo-B---EXo--E--?---B-B-X-E-Mo----oM-ME-oEM-M--B
o--Eo--XoB-B-B-?o---BEXE-?--X-B--B-----BM---BE-B--E------MB--B----EM-EE--oBX---M---BXBM-?BB-oB?--To--MoE-M---B?-M-oMo?-M?oEo---BXTMM-ETB--??---oMBB------Mo--E--?M-M------??-Mo?-E-MEB-?EXEMo-XE-M---BMX
|----X-?------BB-X-B--X---oTo--E--M-M---BE-MMT-X-B--X--?--?XE-E--B---o---M?---B-M-----?M-M---EE--|-B-----E?--?--?E--E--M-E--E--M-|-EMo|--E--M-----E----MX?Mo--XB---oMEBE------?-B--E---E--?E----X-EBoB-?
X----E----X-E---X-B--o-?--o|B----E-----E----EXTo-?--T---------o--M-B---BMo-M----B---?--E-?------?X--B--?B-?-E?-XB----X---oE----M-|-E?-|---M---o-?--?--?------?-BT-------M-E----MoXo---XB---BXXo-E-o-o--E
T---B--E---o---M--BB-E----M|--BX--X-X---EB----X-ooo-|EX--?---E--o-E?---------BEM--M-----B---Bo-?---------E-M--Bo---Eo--EB??-X-?--Xo--?X------?---XX--X-oMEME-M-E|XX-X--M---B?---?---M---B-----?--EBo-?-M
T--------X--?---E---oM---X-|--MoM-E-B---M-----B--E--X-M----M--E--XE?X---?B------B--E?---E----------?---o------E----o-MB-M--M-B-M----X-EM----?B---B---E--o-M-X-BEX-E-X---M---B-oT-oEM----M-o------------B
B----B--------MB-?o-----M-------EBE---E---------?------E-MoB-----o----------o-----T-E-----T---X----?-----?o----Xo---?----E-----M--Mo---EXM---B-?--?oM-----E-M---o?---X-----XEo-|----Xo--M-?--o---------v
TM---E---M---M-B---X-o--EoBX-B----B--?---oX--M-BE--o?EM-----M-E---------B-?-E-BM--X------XX----B---M-----B--T-B--o--o----o---B-B?-o--o--------XB--B-?-B?-X---o-o-M----MB-----B-X-?E----B------B-Xo-E---B
T-----X---o-T--E---E?-E-E------B---o-B-E--E----EM----M--X-?-o---X-E-X-B---oE--E-M-----o?--TM-M---Xo-X-----M-X-EM---X-------X?----oT---Bo--T--XE---E-?----o-------?---X-E--?------?-----EX---X-o--------B
Eo-X---B-MM?X--M------???-E---E-B-o--B--o---?M-----B-B------T-X----E---------B-o---B-----E|----?-Mo-------?--B-ooE--?o---X----XXX-XMo-----X------X-M-XMX----E---B-M---M--X?XE--------o--M--?o-----XX---o
??-M---E----?--?----X---TB-------?-----??-?---T--X----oEMM--X------?---X-o-----M-?------EoX-B--E-ET--BM-o--X-M-------E-B-?X---EB--?o--TB---M----E-----ME-oB-M------T-?-M?o----X---E?-?-M-MT---T-?------X
o?--B----T----o------T-X|--T----o-o-----?-----|B----X--B-TEB--o-----MX-----M-M-E?------X-----oE---XX--M--Mo-?MT------B--E-------------|----------X---------M------T|M---T---------B-ETM---|--E|--------o
--T-----E|-----------|--|--|--T-MT---T-------o|----?-----XT--X-----o------o---T---------?E-------o-----TT-----|-----------------------|-----T---o--------T---T----X|T--T|X-BT-MT-----|----|-T-|--------M
m-|T--T--|--T--------|-T|-T|--|--|---|T---T---|T----------|------------T-----T|------T-----------------||-----|----------T-T-----TT---|-----|--T----T-T--|---|-----||-T||---|--|-T---|----|-|T|--T-----|
XXXXXXXXXXXXXXXXXXXXXXXXXXXXXXXXXXXXXXXXXXXXXXXXXXXXXXXXXXXXXXXXXXXXXXXXXXXXXXXXXXXXXXXXXXXXXXXXXXXXXXXXXXXXXXXXXXXXXXXXXXXXXXXXXXXXXXXXXXXXXXXXXXXXXXXXXXXXXXXXXXXXXXXXXXXXXXXXXXXXXXXXXXXXXXXXXXXXXXXX
