|-MMXX-oMX--ooB-BEM-X-X---MoMXE-EoXM-EM?--oB--o-----oo-??MB-B-?M---M-M-B?--XX-?EE-?----XXX-?-?----MM-X-XB?B?--BoMMBBX?EB-MoM-M-E-???EM-B-XB-X--oo-EE-EE-E-??EE?B---?o-o---o-oM---X---X----?--M-ooMoX---o
M---o--EXo-?B--?--oMB-Moo-X-Eo---ooo---EEB-MEo-o-BBo-MXo---E--X-X-o?B-BM--o-?-BEB----oM-E--?---?X-B?-MB?--?E--?E-?oEM--??--o--E---XoB-B-M-B--o--?Eo---?X-M---o-??EBEB?o---Bo--M-oM-?-E-X-oEB--oEEM?oXB-B
o--BBo?-Mo---Mo-XEE-oE?E?EXMB-?MMo-M--EoX---BXX-B-BBTMMB-B-BMM--BMX?o-BXMXo--E-o---oB--o-?oB?---?-----B----B?----B-EE-X---XoBo--?-E??Eo?o------?-??X-EoE-M---oEBoMB-Mo-Bo-X-X?-XXX-B--X--XE?BBB-E?---XBX
X-------?----E-----E--M-MB-------?----oX?-XE?----EM-|--E?----------M-----?----M-----E--o-?-M?--X-----BE-EX-X----B--o-X------?E---B-B---EBX--B---?X-----?-EE-B---oB----E-T--B-----?----o----BE-----E--E-o
TE--oM-o----XM?---B-E-E-----?----o----------BX--??--|----B------XXMB-E--?--oXE-E-B--E--?-?------M-----M-?o-E---E-?X-M-M-EB--?-M--M-?----BE-?-B----------E-B----?-o----B-XE?---M?--------X-B?o-BXE--X--o-
X-BBM?TM--BBE-?--------B--B?------EX?---M--M-EE--oEXXB---M----?-o-----?o---E-B-BB-------?-Eo-X-?o-M-XE-X---M?EBE--?---BB--EE--B-----MT-ME---T--X----M--?---E-?--X??-Mo---?E----------Bo--E--------oo--BM
MM-?--X---o--M-o-B-MX-----M-B--E-X--B--X---M-B--M--B--?XE-X-oB---B--E---XEE?--B-M--??oX----B---------?--?--o----M-------M---MMBE--?--|-EM-M-XM-Eo--------B?M-----E--M?-Eo-?----MEX------o---M--E-------?
T---?X-----B-B-?--B?--E----?-E--o-EX--M---EEXE--oX-------?---B-?-?--?-B---E--oEM--M-----X---?---Eo-oB------?M-M-----XM-M--X---?---E-?X--?---E---o-X---o-E-o------B---?-E-MB-o-E-M-M---o-?--X--oEB------v
M?-MM-BM-----BB-----M?-----E-E-------oB--M---------B?-E-----M--------XM------o-?------XXE--EE-To--B----E------B----X---oE-o-EM-----E---oo--E-----o-o--M---B------M--oMB-----E?---oM-?o---o--B-----Bo--XB
ooBo?X-----M----X?E--Eo?M-------o?XB-E-----B------------o---oB-----M--B---XE---B--MB-XoME--E--X--?---?o----E-M-oM----M---o---?-----?----M-----TX---M---o-o-XBE-M---E--?---Bo---?--?---------E-?-B----Too
B----?-----ME?M-?----M-----oB-Bo-?MEME---BT-M-B-E?---BE-M---B-EX----oM-B--M--BE-?ET-o---E--?---M--E?--B--M---Eo-?EXE------X------M-------?----|----------M-oM-o--?-?---?--B---E--??--o----BTMEo---?E-|E-
TE--X----o?o----E---o?--B--M--?-o--M-----o|B---o---E-?-oo----Eoo----ME-E?---B----?|--E---oM-?---EB---M--o?-M--XXE----X--oXE----?----X---------XM--o-MEE-X-XE----M-o----B-X?M--?B------XMM-EX--??oX-?M|-B
B-M-----o--M-E--EEM--E-B---ME-oM--X-----??X?E-M-------oE-oo-M-oB?E---?--?--XE--Bo-|M--Xo-M------M-Mo--o---M-X---E-E?-M---E-------B---E-E--o-X------oME-MMMo--?---BMB-M---B-----E--?-?--BMX---o--B----|-o
B--M------BB-M-E----Xo--?X-E---o?o--BX--o--------BXB-ME-X?---o--EoX-Bo--Eoo--o?--o|E---?--oXB-X-EBM-M-------MXE-------?-----------------oE-X---X-----------M---M-o-?X-X----E-X-MoEE-B-M-----o---E-M--X-E
m-o-XB-EXBMBXM-o-EoE??--B-oM--B-o-o-??MoMXo-M-E-BoE-E-oo?BooMo-oEB?----E?oB?-o-EXXXoo-----o--EEX??MBEMM?E--B-MBMMoEB-E---oo-?EXE---XoM--oEM?-X?o-X-X-B--BEEMXoEoE-oEBMoM-o-o-B-?oB-B-X----?ooMXEEBMB-o-|
XXXXXXXXXXXXXXXXXXXXXXXXXXXXXXXXXXXXXXXXXXXXXXXXXXXXXXXXXXXXXXXXXXXXXXXXXXXXXXXXXXXXXXXXXXXXXXXXXXXXXXXXXXXXXXXXXXXXXXXXXXXXXXXXXXXXXXXXXXXXXXXXXXXXXXXXXXXXXXXXXXXXXXXXXXXXXXXXXXXXXXXXXXXXXXXXXXXXXXXX
