-------------------------------------------------------------------------------?---------------X--------------------------------------X--------------------------------------------E--------------------
--------------------------------------------M?--------X--o------B----------------------------------o------------------------------------------------M---------B---------X--------------------------o----
--------E--------B------------------------------o-----M----------M---------------------------o-----------------------?--o-------------?------X---------------o-?-------B-----------------------------X--
-------XX---B---------------------o---------------------------------------------------------M-----------------------?------B-----------------E-----------------------------------------M----------------
--------------E---E--------o-------E--------------------------------------------------E-----Xo--------------------M---------------------------------------o--M-------M----------------------------------
---------------------?X-------X-------------------------------?B---?-----------------------?---------------------------------------------o-----------------------B----------------------------------o---
------------------------------------------X---------?----------------------E---o?X--------B---------X-------------X-------------------------------------------------------------------------------------
---------------------------------------------M-------?-B---------------?----------------------------B-----------Xo------M-------------------BB---------B------------------X-----o----------------------v
-------------------------E---M-MX--------?---------------B---------------------X--------------------M---------------X---------?------------------------------------------------------------------------f
---------?------------------------X?---------M------------------------------------------------E----------X-------------------o-----------------------------M--------------------E------X-----------X---f
------M----?-----------------X------------------------------------------E-----------------------------------------------o--------o---------o----X----------------------------------------------------X-f
----T----------o--------------B------------------?--------------------------------------------------X---B------T---------?-----?----------------------------------T---------------------------E-----X--T
----|----T-----------------------?--------------------------------------M--------------M------T----------------|-T-------------------------------------M--E-------|?------------------?----------------|
----|----|----T------------T-----------E----------------------------------------------T-------|-To-------------|-|----T---------T--------------?------------------|---------------T--------------------|
m---|-T--|----|--T-T---T---|-----------------------------T---------T---T------------T-|-------|-|--T-----------|-|----|---------|-T-------------------------------|---------------|--T-----------------|
XXXXXXXXXXXXXXXXXXXXXXXXXXXXXXXXXXXXXXXXXXXXXXXXXXXXXXXXXXXXXXXXXXXXXXXXXXXXXXXXXXXXXXXXXXXXXXXXXXXXXXXXXXXXXXXXXXXXXXXXXXXXXXXXXXXXXXXXXXXXXXXXXXXXXXXXXXXXXXXXXXXXXXXXXXXXXXXXXXXXXXXXXXXXXXXXXXXXXXXX
