B-XM-BE?X??--M-M---Mo-?---EMX--?XX?-----MTBM--E--B-E-o-o-oo-B?--o---XE-MX-BoMBEEXX--E--?o-o----M-MXE-BE-M-B-?EX-EBEo-oEXB?MME?BX?o-ME--M-XMoE-M--E-MM-E-EE--?-o?MXM---o-oE--???E----EE-?---EBo--XMEBME--
X--X?---X-ooMB?-XBX-BXo------XE?-B?--?-MB|E?-M---Bo?--M?-EM---E-E-E-?-?M--M-EB--oE?--EX---X--EXX-----M--MME----X--MBEo--XMEE-MXBo?---?---oX-?-T-BMBBM----BX--?o---X--EBo?--X-XEX-Bo---M-o-B-oM-?-EEEo-BM
--M?---??X-B?oM-?o?E-oM-M-M-EB------MM-XE|---?B-E?-?--MMBB-?o?--MMMB---o-o-E--o--EoB--?MX?-BEE-B?o?B---o-MM-T--M---MMoE-Bo--XM--Xo--X-E-Mo--E-|-XM--M--MB??-E?X-B---M-E-T-X-M-XBM?---oBM---E----E----?-B
T--T---o-o---BX---B-M-M-B--EB-?Mo-MBo----|------------M---X?-o-B----?oo-o-----?-T-E----T-?X---M?M-?--E------|-B-EB-----Eo--Xo----XT--B----XX--|T-B--M-M------MM---B-----|-o-X?----M?--------BX-?EX----MM
T-?|-X--M------B--B--X---E------M-E------X-X?B-X--o----E-B---BE-oBB----------o--|-o----|-E?-MoB-M---X-X-M?--X-?---M--?--B?o--ME-?-XE----BM?o-M||---Bo-o--BXX-?-EoX------|--M----?oMB----XB-----oB-M--XEM
o-o|----M-?o--B----BX-----o-o-B?---TXX----B-oMo-MX--E-------X-o-------oE---E---B|-o----|-----MB--X--B--B--------X-------BEB---------?-------X-XX--o-BB------o---o-E---BMXBE----BB-oM-----?o-----?----?-|
---|BX-??----Eo??----M--X-oT--?--M-XM-E------ooo----B----E-----?----------?-M---XX-E---|-----EB---EBBX--ME??-o-E---Mo-----E--o-X?----o-----?-?--E-o-o-?o---E--?----?--BB----?-M?-BBo?-XoB-------To-----?
E-?X-----X---MM--------?---|----o------E--X--MM-----?--?-----BMo?----X--------E?-------X---B-----M-oB-X------B--X----X------X---TB-XEEE-------B------------M-B-X--?-B----E--E--BB----E---B--M--oX-E?--ov
E-----o----EM--Mo-----X----|-oo-----MM--E--To--?---M----E----MM--o------XX--TM--?-----B--X------ME--M-------------?TBB------?---|--B--B-?-X?-------E-------B-----M-ME--o-EM-Eo-oo--EX-B-M-B-T-oo---E---B
?-?X-----E-------M----?----|B--XME----M---EX---TMM-?-Bo---X-M-E-M--X-?TE-o--|---E--T-------BM----------Eo-o---o-?--X----BoE--Xo-|-o?--?--X-?---oB---E--E------M-?MBoEE-X-T--M-M---B-Bo------|?--BB--oM-T
M------X--o-EB?-M-X-oo----XX----BE-B----EX-----X---E-----XB-----M?----|--o--X------X---BBM--EoXB------------?M-BM-?--?EX-MMMBo?-|-EM----B---M--B?o---?----TXXo-----E----X|---X---MB---B?B-?-X--Boo-E--EB
--o-T-------BE-Xo------o-E-?--o---T--o----M-?-T--X---o-------B--M----B|X---T?-?-XE-o---------T--E---------------oX?---------o---X?M-------B------?-----M--|-----------M--X--B-M-T------?E---MT-o------Mo
M-B-|---E-------o-------X----B--?-X--B----?M--|----MT-E-------o-------X----|---------XX-o-T--X---E----?----------?M-M---B----o-------?oE--?--X------Bo--o-XoTBX--------M-o-----X|-ET--------oX---?---X-o
E---|--T--B-------B-B-----T---?T-----B----Mo--|--TT-|----------X--T-----To-|-----T--------|----T---------M-----o--T--M---------------M------------T---------|--T--T-------------|?E|--T---------E--T-E-B
m---|--|--------T-------T-|----|--T-----------|--||T|---------T---|-----|--|-----|--------|----|----T------T------|T-------------------T----------|----T----|--|--|--------T----|--|--|---------T--|--TE
XXXXXXXXXXXXXXXXXXXXXXXXXXXXXXXXXXXXXXXXXXXXXXXXXXXXXXXXXXXXXXXXXXXXXXXXXXXXXXXXXXXXXXXXXXXXXXXXXXXXXXXXXXXXXXXXXXXXXXXXXXXXXXXXXXXXXXXXXXXXXXXXXXXXXXXXXXXXXXXXXXXXXXXXXXXXXXXXXXXXXXXXXXXXXXXXXXXXXXXX
