-------------------X---------------?--M---?-------o--------------------------------------------------------------Mo------------------------?----------------------------X-------------------------------
--------------------------------E----------------------------------X---------E----------------------B-----------------------------------------------o---X----------X----B-?-------------X-XM-------?----
-----------------------------------------------------M-----B------------------------------B-------X------------------------------------------------o----XX-----------------------------------------X----
-----------B-----X---------------------?--------------------?-------------------M--------------------B----------------------------------------------------------------------------------------?---------
-----------------B---------E------------------------------------------------M--------------?-------------------------------B-------------E------------B-------------------------------------------------
----------------------------------------------------------------------------------------------------------------??-----------------B-----------B--------------------------------------------------------
----------------------------------------X------------?---------------------------------------------------------------------------------------?--------------------------------B-------------------------
----------------------------------------------------?---M------------------------M-M-------o----------------------B-----M---------------------------------------------X--B-----E---X------------------Mv
-B---------M--------------------------------?-------------------B------------------------M--------------------------------------------o--B-------------------B-----------------?---o-------------------f
-----------------------------------------------E-------------------------------------------------------o-------------------------------------M----X------------------E---------------------------------f
------E----------------------------------------------------------------------------------------------M----------------o--------E-----------------B-------X---------------------------------------------f
----------X-----------------------------------------------------------------------------------o--?------------------------M--------------B---------------------------------------------------------X---f
---------------o-----------o-----E------------B-------------------------------M--------------------E------------------------------------------------------------------------------------------------X--f
-----------------------------------E------------------------------------------------------T------------------------------------------------------------------------------------------------------------f
m---------X-X---X-X---X---Xo-XX-----------EX--o-----X-------?X-----?--X---------X-------X?X---?-----X-----------Xo-----?------X--X-----X-B-?X----XX-X--------X-oX-X----------X-o-------X---------------f
XXXXXXXXXXXXXXXXXXXXXXXXXXXXXXXXXXXXXXXXXXXXXXXXXXXXXXXXXXXXXXXXXXXXXXXXXXXXXXXXXXXXXXXXXXXXXXXXXXXXXXXXXXXXXXXXXXXXXXXXXXXXXXXXXXXXXXXXXXXXXXXXXXXXXXXXXXXXXXXXXXXXXXXXXXXXXXXXXXXXXXXXXXXXXXXXXXXXXXXX
