----------------------------------------------------------------------------------------------------------B------------------?----------------X-------o----------------B----------------------?---------
---M----------------------------B-----------------------------------------------------------------------------o-----------E---------o---------M-------M---------------------------?-----B---------------
-------------------------------------------------------?---------------------------------B--------------------------------B---------------B-----------------M-------------------------------------------
---------------------------------XX--------B-----------------------------o---------------------------X?--------------------------M----E----------------------------?-E-----------------------------M----
-------------------------------------------------M------?-------?X----------------------------------------X----?---------------------------B-------------------?-----------B-o--------M-----?----MX-----
--------------------------?--------------------BB---------------------------------------------------------B------------------------E----------E---------------------E-----------X---------B-----BM------
--X?------------------------------------------oM----------------------------------XX--------------------------------------X----------------------------------------------------M-----------------X------
-------------o-----------------------------------------------------------------------------------------------o---------?----------------EX-------------------------X---------------B-------------------v
---------?------------------------------------------------------------------?----------------------?-------------------------------------?------------------o------------------------------------------f
------------------------o-----B------------------B------------------------M------?-------------------------M-------------------B-X--M-----------M---------------------------------X--------------------f
-------------------------------EX-------------------------------------------X-------------------------------------------E-------------?-----M----------------------------B-o-----?---------------------f
-------------------------------o--------X-----?--B---TX----------X-------------------T---------B------------?--?------------------------M--------E---------------------T------------M------------------f
-----------T-----------------------------------------|----------B--------------------|--?----------o----------------------------------M-----------?--------------------|--------E---------T---o--------f
-----T-----|----?------------------------------------|-------------------------------|--------o------------------------------------T--------------E--------------?-----|------------------|---E-T------f
m----|-T---|---T---------------------T---------------|-T----------------------------T|---------------------------------------------|---------------T----------T--------|------------------|TT---|------f
XXXXXXXXXXXXXXXXXXXXXXXXXXXXXXXXXXXXXXXXXXXXXXXXXXXXXXXXXXXXXXXXXXXXXXXXXXXXXXXXXXXXXXXXXXXXXXXXXXXXXXXXXXXXXXXXXXXXXXXXXXXXXXXXXXXXXXXXXXXXXXXXXXXXXXXXXXXXXXXXXXXXXXXXXXXXXXXXXXXXXXXXXXXXXXXXXXXXXXXX
