MoEEM-oo-MB-Bo-EEE-o---o?----XBEB?B--M--?-oo-?---EM-XoTB---E?--?-?BXB-EBo??BXM----BX-EB-?XM?Eo-MooEM?XMEoX----oX-oE?E?--XX--MX?MBEB-M-M--Mo-MMME-EE-X------o?E-Xo?BMX-?M---EMMo-?XM---M--oM-o-B-?--M?BoX
-EM--B--XoM?--E---oo--o?M--?MB--X----B?XEooEo?MM?B-BX-|--M---X-X?EEX--o-?--Bo--MM---oE-oM-?M-E-----X--BB-E---XXBEEo-MXMEX-BoMMEE--X-X----o-X?B?M----oEX-EX-oM-E--M?BEo-M-o-M-?XMoo-BM-B---X-MXEEE-Eoo?-o
oo--E---E---Eo---ooB----EE-XTX-Xo???-o-E-XB-X?o?--BT??|-B---MB-M?----M?-ME---MM??-X?oXXMM-E?M?M----B--?EE-BE-oE--E?------o?--EXX-?---oBoE----B-BBBBoEXMXM-B---o--?--EE---E-M---oB?BM?--E---?--M-MEB?X-?X
EX--?B--ME--B----o-E---M---X|-----------Bo-?Xo--MT-|--|--------oT---E-----o-----MBT------------E------o-o----EX-EM----E-o-X---M-----?-oo-o----?BE-E---o-o-B-----Eo--------M----M----?---E--o---X--EB--oM
|-MB?o--T----BX-X--?-------E|-X---E---X-EoM---BB-|-|XoX----M---M|?--o--X---Mo-MXEB|E----M------o---M--BEoX------M-X---EX---M-?-o?-o--B-------M--BE-B----E-----B-M--M---B------?----?---oB?--------B---BX
Mo---?--X?-M---E-----XB?--XE|-E-E-?-----M--TX---E|-XME?-MB-M----|-------X-----B-BM|---M??-----Xo-XX----M-E--B-B-M--ETE-MoT??-oX?-----MEX-E--EE--------B?BE--------o----B-M-----M-oE-------M----MM----TB?
?--M-----o---o---oE--B--EE--X--------EE----|-X---|-E-----EE----oX-o--X-----------?XB--o?---XXM--E?E-o------TE-----X-|-M--|---?--X-----M--T--E-----EM-EB---M--X--oEE----BB-oE-?B-MoM--BMM-M-X-B----oBo|-M
|--E--?---T--?B-o------M--B-Bo--M------X-?-X----EX-BM-XE---?M-M----M---?-----?----E---?-M-?EE-?B--MB-E--M--|-?BM---BXM-o-|EX------EB-----X-------Xo-M----EB-Xo--MME-M----X--B?B-?-?---o-M----M----B--|?v
--M----E--X?M-B------EX-?--E-M-------------?B-X----M-o-TME----------X-------MB-MB--E-----?T-BBE--E-B-------X-----Bo------X--ooE-M----T----o-?-----B---Mo-o---o---B-------B--T------E-------?--E-M--E-|-B
o----E?EEB---B-BE-X---B---o--E--X--------?M------o-MMM-X------Xo-------MEX?B-?o----BM-----|M-EMo----?T-?E-M---------?B------B-------MX--E---MM-?-o-B-E-EX--o--EE--M-oo-TXM--X--------T---M-----------X-?
X?------?M-?---B---BX---X-E----------BX-B--E------X--EE---E?-------X---T-E--BBo---B-------|-?---o----X-B--BBXEBMo---oBM--o-E--Eo--?---M-MM---?-----o------M-B-M--XoE-BXX-?-EB-M-XX-XXXoE-o---M?B?-E-?M-B
o-------T---o-?---EB--------TX--X----?--------B-Eo-----MX--?-----------|--M-?B?-----M-----XE---E--M---?-o?E-E---TM------?-?----o----?--B-B------------B--X?--?B-------o------o----B--EB---Xo------T?o--?
?-B-----|-----?-----B--XE-??|----------T----E-------------o----------B-X-M--?----------T------------------------|-EX--T---------T-B----M----o-M---------B-------?-E-T-o--??-M--M----T-------------|---BT
MT--E---|--T----------T-----|--------TXX----TB---------B----T-------TT-----------E-X---|--o-TTT--T--------------|-----|------T--|M?----ET----TT---T----E----------M-|-To---o--T-T?--|----T-----T--|----E
m|--T-T-|--|--TT---T--|---T-|--------|------|-T------TT----T|TT-----||-----------------|--T-|||--|-----T--------|-T---|T-T---|--|-------|----||---|--T--T---T------T|-|T--T---|-|T--|---T|-----|--|----?
XXXXXXXXXXXXXXXXXXXXXXXXXXXXXXXXXXXXXXXXXXXXXXXXXXXXXXXXXXXXXXXXXXXXXXXXXXXXXXXXXXXXXXXXXXXXXXXXXXXXXXXXXXXXXXXXXXXXXXXXXXXXXXXXXXXXXXXXXXXXXXXXXXXXXXXXXXXXXXXXXXXXXXXXXXXXXXXXXXXXXXXXXXXXXXXXXXXXXXXX
