?---X--X-B--oEM-MoX?E---BoB--B--oEM?-M---B-o?----M---o----MB---X--MX--MX?E-?oX----EBX-??-M-E-----??E---M-M-MB?-M------X-B-MX-XXBX?o--MM---o?-------ooEo?M--?-?o??M---E???o-o?-??----MXXBo?--MBEEB--B--EB
?-E-o---Xo?E-B------BE--X-oE-M-To-o---BE--ooM----?B----??TBoM---?XE-BX--B---oM-Xo--B--XB?XE-ME-B---X-M---BMM-?E-BoB-M-E-M--MoEXB?o-o-------??EX---XM--E-BE---?TB--BE-o-----o---M-----MEo-M----?-E-o--E-X
TE--M----o---------oo-EM--?oM--|---MXBo--E--B-MX-ME--EoM?|--?X-E--X-?--E-E-o--M--o-X-E-M--X??-----E---------?EX-E---M-E---XoEo-M---M------X-X-M-EX-B---oE-M---|M---Bo--XT?T--E?BMT-------o--o?-?o---MMEE
o-----ME---M-M--B-B------------|----E-T---------B-----B-X|------?T--?-------T--E-oM---T--X-----E-X-B-XoBE-o---------o-ET------------?--------X--B---T-------B-|-o--E--X-|-|-MTo--|----M-----?M----B----T
B--E-E--o----M---------XM-BE---|E-----|?-E-----------EE-oX----?--|-BE--M-B?-|BT--?-T--X---E-Xo--E-----Mo-o-------------|-----M--?o-----o---E--EBB---|---o-X---|-o-B---o-X-|?-T---X------B-??B--------E-T
X---ME-o--------------E--X-----X-T-?--X----E-o----?--B------XB---|---M-----oX-|-B-BX---M------B-------M-----X-------?-oXM--T----?o----------X---TM--XX---M-TEMX----X------XM-|-M--------?-------B-M---oX
E---M-E-?---B-----ETo---------?-M|----M-E------------M--T-----?--|T---M-------|---------B--B--?TX-M-----T---M--o--T-E--M?--|---o-----XE-MM-Bo-?-Xo---?--o-M|-?--B-o----------|o-X--T---E--E-----B-B-T-?-
??-X-T-o----E-oM---|----TB-------X?--E---------?------?-XX-?-----XX----B----B-|E------M?----?oEX-M---T-BX-------X-|------E?|--?-------?E----M-B--?---?B--E-X--EBo--B-X--B--B-|-----X--B---Bo-E----B-|--v
-o---|---------o---|---E|---X----BE-M-M-B----oBo--?EX--EoB-?---X----o----X?---X----B-M--?---M?ME-----|----M-?----E|-E----o?|-BToM-----E--?--B--BE------o--M--X------E-----o--XT-E--?-MoM-B-T---?--?-|--E
E--?-|------E--M---|--?-X--?-?XM--?-o--B---B---BXM--Mo------TB-----o------o-BT-M----?-?----E-------T-X-----o------|--?-----X-oX----E-----?------MooET---E---X--M---E----------X?-Bo--------X----o--oX--T
B--M-X-M?--EB--?o-?XXo--E----E------?--EB-?B-E?------M-B--o-X-MBM--------o---XM--T-------o-----B---X----------T---X-----XE-EoM-B-X?------?-M----?B-?|-----B--X---------M------?----ME---M--oE---E-----E?
M-?----T-T--TTX--?-----E-----B-BT------o----------T-----E----BE------T-T--M-TE-M-X-----------T--------?T------X-?--------o----EB--B--B---E----M-M---XE--------E--------B--B-M----?---E-----T------BT---T
B--?T--|-|--||-TT-------TT----M-|T----------------|-TT--TT-------T---|-|--T-|--------E----T--|T--------|--TB-------------M----------X--------E----T--------------o-T------T------?---B-----|X--o---|---T
----|--|-|-T||-||--TTT--||T-----||-T-T-----T------|-||--||----T--|--o|T|-T|-|---------T--T|-T||--------|--|-T---------o------------T---------T--T-|----T----T-T----|------|---T------T-----|T---T--|---M
mT--|--|T|-|||-||T-|||--|||-T---||-|T|-TTTT|-----T|-||-T||----|TT|---|||-||T|------TTT|--||T|||-T-TT-T-|-T|-|----TTTT----TTT-------|T--TT--TT|TT|-|T-T-|T---|T|TTT-|-TT---|TTT|T----T|-----||TT-|TT|---?
XXXXXXXXXXXXXXXXXXXXXXXXXXXXXXXXXXXXXXXXXXXXXXXXXXXXXXXXXXXXXXXXXXXXXXXXXXXXXXXXXXXXXXXXXXXXXXXXXXXXXXXXXXXXXXXXXXXXXXXXXXXXXXXXXXXXXXXXXXXXXXXXXXXXXXXXXXXXXXXXXXXXXXXXXXXXXXXXXXXXXXXXXXXXXXXXXXXXXXXX
