---------------E--------------------------------?---------E-------------------------X------B----------o-------------------o-------------------------------------------------------------M-?----------X--
--------------------------M----------------------E-------------------------------------------o---------o------------------------------------------------------------------------------------------o--X--
-------?----------------------------------M---------------------------------------------------------M--------------------------------------------------------------E------BX----------------------------
---------------------------------------------------------------------------------------------------o--------------------------o-------------------E---M-M----------------------------------------E------
-----E-----------------------------------B-M------------------------------------------------------------------------------------M---------------B-----------E--------------------------------X----------
-----------------------------------------------------------------------------------------------------X-------------------M--------------------------X---------M-----------------M-----------------------
--------------------o----------------------------------------------------------Bo-o----E--------------------------------------------------------------------?---B---------------------------------------
------------?---------------------------XX---B-------------------------------------------------------------------X---------o-----------------------------------------------------------------------X---v
------------B-------------------o---------------------------M-----------------------------o-----------------------?------------o-----------------------E-----M-----------------------------------------f
-----?----------B----------M-------------------------------------------------------------------------------------E--------------------?------------X---------------------------------------------------f
--------------E---------------------------X-----------------------------------E------------------------------------------------------------------------------------------------------------------------f
--------------------------------------B---------------------T---------XB------?-----T---------?------------------------B-------------------------------------------------------?--------------------X--f
------------------------------------------------------------|---------------------B-|-------M-----------------------------------------------T------------------------------o---------------------------f
--------------?-----------------------------------------X---|---X-------------------|--------B-------------------------o---------B----------X-------------------------------------------------------T--f
m------X------E--------B--------X---------------------------X--------X-X------------X-------------------------------------X------------------X---------?-X-------------X--X-----------X----XX-------X--f
XXXXXXXXXXXXXXXXXXXXXXXXXXXXXXXXXXXXXXXXXXXXXXXXXXXXXXXXXXXXXXXXXXXXXXXXXXXXXXXXXXXXXXXXXXXXXXXXXXXXXXXXXXXXXXXXXXXXXXXXXXXXXXXXXXXXXXXXXXXXXXXXXXXXXXXXXXXXXXXXXXXXXXXXXXXXXXXXXXXXXXXXXXXXXXXXXXXXXXXX
