--?-?Mo---o-EB-B-BX-----X--M?-----BEM--?MBo-BoEX----XEBX-B-B-E-X--X--?MX---X-----XX-oB-ooXXoX--o-Bo-o-oo-E-?M?-XB--E---M-X--?EoBoEB------MXE-o--M-o--?-M-B-Mo--EB--oBBM??E---o-X??-E?oB-M-BXB--oEE-E?M--
-E?-M-----?-oMo-E-MM?--oEX-E-E-o--oMEoX-X??E-BBoEoX---E--??---E--MBMMM?-B--B-B-Bo-BEE?MM----B-----MoBo-?E---MM-E--o?--MoB??-BBX-EE---o--MEB-BX?B-oXEEB-ooM-MM---Eo---M--E-M--?---M?XoXBEooBE-oME---BoX--
--BEXM---oB--B-?---MEBEMM-?B-oX?-o-o--??-X-M?---M---oB-oMBX--E?oooM?-?EoE-E------?X-EM-B---BM---?o-BM--oEB--M-ME-?B-?BMX---Xo?EB?MEBX----BM--E----M--BB-X?M?-BX?M---X--B?-ME---o--BE-B--oMB-o-MEXo---?--
----M----X----E---?X-E--?--M?-E--o----o-?-Eoo----?XX-----M------M----E-X-Mo--E-?--X--o-----?M?-B?--E-oEM-------?-?----X-------ME---------B?B-?MXMoE----B-E---E--B--?--?E--------MMB---?--EXE?E-o-X-o----
-?o---M--E-T--B?EX--B--X--MM-M-X-o---B?--------X---B-B-o?--?MM-EM--o---oT-------BBMB--X---o----?--------EB-Eo-----M-o-oX---oE--M--o-----XME--MB-E?-B------M---XXE-E---E--XBEB?-----M-?------E-XoX-------
---B-?-BX-X|----o----?X-B-B?-?-M-E?E-M-?---oX--M---?----o-----M--XB?MB--|---X---------BB-B--B---X-X-EoB-?-B--B---o--o-o-B---EX----oo--E-M--o--o----E--B--M---MM---o------oo--o-o---MX?-o---?---B?--?BB--
-o?-o-B---M|------M-----M-----B--B?B----?-M--B-----o---?E--M-----E-Eo-B?|-?-M-?BM--XB---?--B?----oBXEM--B---M-B---XBo-M-M-Eoo-B--M?o----E?-B----M----BMX---Mo--------o--o-?B-B---ME-E--B---M--?E--X-----
-M-?--M-B--X---EME--oE-M-o-oME?-----------MBo--E--E-B--E-B-----o--X--o-o|MBo-----B--?-MM-----EB-B-----?---B-?-?M-B---M-XME--------?-M----?E--M-BB-B-----MX?B---X--EXM--B--ME-E--------Xo---??--oE-?-M-Mv
--?---E---X----B--E----E-----BEXMXo----Eo-M-M-E----M--o-B------oEM?-B?-MX-o?------M-Moo-B--?TE?------X-o?-BE--MoM----M--Bo------MM-E----E--MB--E---B-Bo-----ooBo-E--?--BBM--E---E-X----?-M-?----o-MM---f
--M-----B---E-o-E------MBo------B-T-X-?o-o-?----EME---------o-------B--?--o-----B-----?B-M--X-M-ME-B-oBo---?o--?---------B---EB-B?---B--o?------MoX-B--oM--o---?----------o---B---BoEM-----M?M--B-?----f
---BEoX-E--M---B---E--Xo-MBo------|---M-oEoE-----oE---X---B--Boo--o-o-X--------M---X--MM---B-BMB------------M-?E?E---M--------?---?--E--o--o?---?-E-?----oo-B??-EE-o-M--E??--?--MX---BE-EXoBB-----BB-B-f
---M?-B----MXX---------E--E-XM--?-|--?E------?B-B-----MBX--oo-B-------E-E-----?--o---BE-?B------------o------T-E---Eo-----B---?-Bo--------Eo?------o-M-M---X----E-M---o?--B-M-oo-----o---M-B-----?-M---f
-o-----o?----E-----E-o------------X----M---E---E-EXX----o---E---MM?M---XBX--------BX?--------T---Bo--?-X-o---|---?-o--?-o-M----Mo-X?o-Bo-------o-----oE---??-B--EXo-XBM-E-BE-------E--------X?-Eo-X-oE-f
-B--EM--?-M?--B-??----Bo?------B-----X--BE-----?---o----------BE--?---MB--o-----M---E----M-X?X-o---X----M----|X--?o----T--------o-?--------M-------X-M---oM--oE----BM-------T---oTo----M--XM----?X-B---f
m--EM--EoX??EM-E--X?-?--?--EBEM------B-B-?M?B-?--B??X-M--X?oX-?-X-MM?MBXX--oXE-E-XEMM-MoMo-E-EE--EX-Bo-oM-B-BXoBBM----MX-X-EX--o--ME-XMM-E--??X-Eooo??EE-?o?o--E?-BEMB?MEM-EX--EMX-o?X--MX-?X--BEMM-BM-f
XXXXXXXXXXXXXXXXXXXXXXXXXXXXXXXXXXXXXXXXXXXXXXXXXXXXXXXXXXXXXXXXXXXXXXXXXXXXXXXXXXXXXXXXXXXXXXXXXXXXXXXXXXXXXXXXXXXXXXXXXXXXXXXXXXXXXXXXXXXXXXXXXXXXXXXXXXXXXXXXXXXXXXXXXXXXXXXXXXXXXXXXXXXXXXXXXXXXXXXX
