|??-EB----Eoo?BXEM--B--MX---EX--MM-?-?-?-B-o?oMMM-o--Eo-XX?MMX??B-oMBMB?-?EXM-E---EXoo--??-XXEX----M--EEB--o--o---EE-E--M--MXB-X-BEo-B?--Eo-BX-oo??-EXBX-E-X?MMo----oXMXB-BoE?-?-oEooXX?EM--oMXo??-M-oME
?E-X---X?EoXMEE--Mo-EME-?--EB---BB-BMBB-?oEB--MX-E--X---ooE-o---EB---BME-X--o-?EXB--B-o-o?o----B--?-oEXXo-BB-M?MBM?ME-X-oBM--?E-E-?E---?EBEXo-EB----X-X-?oM-EE?B--oBB--?EoX?-M-M?B-E?M-?MM-EME-?---E---X
E--?----BoE?E-ME--o--EoBE-o-E--oB--BMBXB--MMME--B-E-M---Mo-M?M-E----oM--X?BXX--BB--??XE-BXB--XX-Mo--EE-E------o-oM----o--X--E-M----oM-oM-Bo?---oX-MMo-MX-MMM----BE-M--X-BEooo--EMME---B---M-Bo?--B??BXXT
---BB-----?-EM-o---E-X--EM-M-o---BM-E-?XB--oB-E-oX-B?MM-------M-?--M-B----E?--M---o--B-B-B---E-M--E--B-oX--oBX--MB-M---oTE-----EBM-E----M-MM---E--M-?-E----------B---------E?MB---EMMB-o-EXB--Bo-B---BE?
M----E-M--o-M-?-----XMBXEB?----E-o---X--E-?-EB----ooM-?-------MB-oM---?--E?---BMBBM---EM-------oo---M---o-B----BB-EM-o?M|-?---M-E-BE-?---BE---E-oTM-MXoo-B-X-EEX-M-------XoE---?------------??oE--T-E--B
o-----o-o?-E?BBT-X----B--M--?-M--E--E-?XM-E----?---?-XMM-----E--o-M-?o-----EB----B------------B--Eo--E-----??--?oo--X--EX-?----E?----TE-o--EEE?-B|M--B-B--M-M-?Mo--X----M-----------o------------EX--MBo
BXX-?--MET----X|----oX--?M--?--E----M--B-XT-MXX---B-X-ooX-EBE--o?B?--B--o-----XE--oMB-o---E-EE------?---------------------o---?---X-X|M-M---oM---XE-----?-----E---?-----?---------XX?-MBB---X--------Bo|
T---E-?-E|?-?MM|-----?XX----EXBM--M?--E--o|----o----?----o------o--BB---M-B-MM---?T--M---B-X-MEEE---B?M---?M----X-----E-----------o--XB--E-o---oo-----B-E--o-B----E------------MB-o-?o---B-?M-o-B---M--v
o-o------|---?-|E-E---E---M-E-M--X--M--B--|XBTE---oo-o---?----?E?E---X---B-B----E-|---BMM-M--M--?-------MoB--?oE-XM?--o--B-----X?-?------?-?----BX--XXB------EB--M--BBooEB--MX--o--BE--?o-o---------oE-o
MMM--oo--XB---MXM-?E-BM-----o-MMBE-----E--|-XX--------E--------M-M--E----EE-------XM-BB?---E---B-o--------E--?--X----EE-M--MM---oEo------T----oB-E----?--MX----o-B-B----MBX--?------?B--?-EM-----?--BMXB
B-oTX-M----XB-BM-?oM--------E-o------o--oXX--o-------Eo-----X?E-o-?X-M----M-------oo--E--X----M---oBEMX---?-E----Bo----M--o----E--T------|o--B-------X--o-o-----X----E-Mo--BMoB-M-B-MM---E-----M--XM---M
---|o-oM-X-M?-B----??----E----MT--EoEB-o-----o-o---Eo--XX----M------M--oX-?T-----EMMXB-?-?--E--M---E-?-Xo-MX??-E-?XXX---o-----EM-o|---X--X-?----XM--EE-----B-?---oo-------?--E---XM-M--B?-------E-MM---M
MX-|--Bo-M-----o---B--M?--o-M--X--o------XM-B-----M-----M------X-o-----T---|--ME-M-T--o--E----B-EB?-E?---------Mo?--------o-----B-X-o--XBME-----M---B--?-X---?-E-E----?MME--oE---B-X-E---MM-BE-BB----M-E
|--|--B--B--B-BM-o-------MB-?-X-----o--X--?-----o--BM--o---o---ooo-MoME|---|---MX--|-BE---BX-o?X-M-oo-M?--B---?--MX----------X-E-----?-B?--oM----o--------------EBM--o---B---o-X----oo?oB-----X?o-----?E
mBoX-BEB-o-XooM----Xo----E-M--EXo--E-EMo---BEMoM?B--MBM-B?oE--o-o?MB-M-X-EBX?MoEMXMXE-M-MM--M-B-?EB--oMME-?MMX?o--?-M??-XM-XM-X?XMM---EB-XX?oE---XXXMBBXE-ME-X-oBoo-EM?X-oXoX-E-EB--?MM-M?--X-??EXE?XXBM
XXXXXXXXXXXXXXXXXXXXXXXXXXXXXXXXXXXXXXXXXXXXXXXXXXXXXXXXXXXXXXXXXXXXXXXXXXXXXXXXXXXXXXXXXXXXXXXXXXXXXXXXXXXXXXXXXXXXXXXXXXXXXXXXXXXXXXXXXXXXXXXXXXXXXXXXXXXXXXXXXXXXXXXXXXXXXXXXXXXXXXXXXXXXXXXXXXXXXXXX
