------------X---o---------------------------------B--------------------------o--------------------------------------------------------------------------------------------------------------------------
---------------------------------------------------o---o------------------------------------?---------------X----------------------------o-----------------------------------M--------------------o-----
-M-------------------------------M---------------------------------B-B---------------------------------------o---------------------------------M------------------------?-------------------------------
--------------------o------------------------------M-----------B----------------------------------X------------------?---X---------?-----E------------B---------------------o---------------------------
----------------E-------------B-------------------------------------------------------------------------------------------------------------------------------------------------------------------------
---------------------------------------------------------------------M--------------------------------------------------------------------------------------o-------------------E-----------------------
-------o------------------------------------------------------------------------------------------------------?------------------------------------------------------------------------------------X----
-----------------------------------------------------------------------M?-X----------------E----------B-------------------------?---------------------B------------------------------------------------v
------o-----------------------o-------------------------------------------B----------------------o---------X-------------------------------------E-------------XX--------------------------------------f
--------B-----------------------?--------------------------------------------------------------------M-----B-B-----------------------------------------B------E---------------M------------------------f
------------EB---B------------------------------------------?--?------B-----------------------------------------------------------X?-------------------------------------------------------------------f
-------------------------------B-----------X----------------------------------o-----------------------------------------------------------------------------------------?--------------------------T---f
----------------------------------------------------------o----------------------E-----------------------o---?-----------------------------E-------------------------B---------------------o------XX---f
---------------X------E-------------------------E---------------------------------------X-M--T-----------E-E-----------T---------------------------------------------------X-------------------------X-f
m--------------o--------------X-X--------------M---------------------X----B--------XX---B----X--X-------------M--------X---X--------E---X---------------X--X----------------X----M-----------X---------f
XXXXXXXXXXXXXXXXXXXXXXXXXXXXXXXXXXXXXXXXXXXXXXXXXXXXXXXXXXXXXXXXXXXXXXXXXXXXXXXXXXXXXXXXXXXXXXXXXXXXXXXXXXXXXXXXXXXXXXXXXXXXXXXXXXXXXXXXXXXXXXXXXXXXXXXXXXXXXXXXXXXXXXXXXXXXXXXXXXXXXXXXXXXXXXXXXXXXXXXX
