BM--MME-oB--?-BME?-?X-?-XXXE----oE?-------BE-E--?EX-M-??--oM-M-Xo-E???X-XE--M-E--EEE-?MoEoMEMX?--o----EE-M--o-E--ME-?-B-EE---M?-E--XoXMBoM-X--BX-B---E?BMBoB-----X-E----?EEMMEX?MXME---oXMB-XB?ooBMX--o?
B-MX?B---XE?----MEoX-o--XX-?-BE-?---X?EX--?oEE-E---BXM-E?-?MXBoBEo---?EXX?--?-E-M--X-MMX--?-oo?-X?BXBX--o?--BM?E--M-ME-?oo--M?-BEB-M-BM?E------M-M-oM-X?E?E-M-Bo?---o?oX-?M-BBBEMoEB----?BoE-Xo-BMoX--XM
E?E-------BM--E-oM?---BM---MM?MMXB?-M?oM-E-?E-E-E-MXBB-E-B-?-?-XB-XX-MEM-M-?--B?BE-M-o-?BEo-?----EB-?----E--?----E-Mo?oB-EE?-E--o--X-E-X---ME-X--BX--o-BE-E--M--E?X-Mo-B---BMM-o-?--?-XEE-----MME--M--Bo
M-B--o----?--BX---?B-Mo--E-?E--?--?---B--?-------o?-----E-M-?--------E-B--------M---X-XEo-EX---XoM--ME-o?o-X-EB------M--o-BM-M--o-------?---?-----X--------XX------T---E-M-----X-o--------?----XM-M-Xo--
--TE-M-M-o----M--o-----X?B-M----T--?-Xo------?--M-o-o-T?---M--?-----M?-M-------X------B-----X-o--o-X-------------E--B-----o----M-----o---X--o-X---E-oEX-B-X-M--E-?-X-------?--?-X--M--M----------Xo-M?-X
?-X--B-oXB-----B?----MEB-EBo--XT|------X-----?-?----B-X---?------M----B--X-----M----M----M-X-E--M----B-X---BXM----E-----------X?-X-----X-?-XM---EB--M---M-E--MM-X-BMBE--E--o--E--B-----?-?M-BB----ME-?To
?E-M--B-E----------?--o?o--?XBMX|M-X---o--E--oB-----o-B-----T--?-Eo?--o?-------?---X---B--BEX-E----TMB----E--M--o---EoXo----M----?XE--------E-M-?-E---T--X---M-M------o-E--B---E--?--?M---------------|o
X-?--o--------BB---BM---o--B-?-E|M-E-o----------E-oBo?B-----X--EB-?M--B----X--------B----o---oE---X|oE---o---?--MX-M-Eo--o-Mo--M-----------XE-M-?-o?-M|-----T--?--E?-E-E---M-----------E-----------?MXXv
-E--?--E-E----o-B---?--o------M-X--EB?----EX---?o--B--EE-------------M----BE-?o---X------M----M-E--X?--E--X-M---oM------?----X--E-XT-B-XXX-?--TMB-E---X--M--|-M--E------?---Mo--?--E-----?-----M-X----?-
ooEE--?-----?B-B-?--BX-?BM-oE?-?-MX---Bo---?-----?-B----oEX-----XM-X--o-X---o------B----T----B-X-E------------?-------o---X-E-oo---|oEo----o--X-M-?--------o|---M-Bo-X---X-E-M?---o---------?------M??-?
?-?-XX?B-?------?M-?-?----o?--------M-M--E---E-?o---XXE-?----M--T?E-X--E--E----M-o-Eo-?oX---M---M----oEMMBE-?X---?MB-BT--M?--------|-M-------o-o-EoBo--o-ME?X----X-EB-M-----?--o----Bo-?------o----o---o
B--?-M--------M-------------------------MB--E---EM-E-----X----B-|-------------?-oT---?-BBE---T---------M-BB----?------|MMM?-X--E---|--o-T-X-T-------------M--B--E-----B----M-?--B--?---B--------B---X--B
E-------T-----?X----ME-M-T-M----o--o---B-M-----T--?-T--X------B-|----------------|-----B-o--X|-M--T--X--B-----To------XB-------T---X----|E--|--?-M---------MT----T--T--X--T---E-o-----X?----B--X-E-----X
T----B-T|-----------Mo---|T-T-----------E---T-T|----|T--T---?---X--B----------T--|------B----|-M--|----M-o--T-|-------T-T-X--o-|---T----XT--|---------------|---B|--|---T-|------X---E--T--------T------
m---T--||-------T------T-||-|--T-T----T-----|-||----||--|-T-------------------|--|-----------|T---|------T-T|-|-------|-|-T---T|--T|--TT-|T-|-------T-------|----|--|T--|-|-------------|--------|-----?
XXXXXXXXXXXXXXXXXXXXXXXXXXXXXXXXXXXXXXXXXXXXXXXXXXXXXXXXXXXXXXXXXXXXXXXXXXXXXXXXXXXXXXXXXXXXXXXXXXXXXXXXXXXXXXXXXXXXXXXXXXXXXXXXXXXXXXXXXXXXXXXXXXXXXXXXXXXXXXXXXXXXXXXXXXXXXXXXXXXXXXXXXXXXXXXXXXXXXXXX
