ME--Eo--MME-BB-ooo--oBMX-MM---E-Bo--Eo----?oBEM-XMoXE-X--??-BMBB--M-X?-------EEXE---?Xo-E---o?X?EBXM-E--?-BE--B-?-BBB-EXoXXMMEX--Bo--?EX--M-EEX--M??M-EEM--o-XX--?--M-?Eo-ooE-MX--??-----o-Eo-EoE-MXM?BT
oBM-?-oE--oM-EBME-B-M--MoEM-B---MXXB-EBX---X?XE?M--XM?X?XoMo-E-Mo?-E---M-EXMEM-X--oX--X-----o-M--EE-?E--Xo--BMB--X-BX-o-?-BBEE---X-?X--?M---?---BoE-?EE-ME----BMB--E-XB----ME-ME-E-MEo-MoMBBMXE--?BX?Eo-
|o-??-oX-ooEEoBoB?EE--EX--X-E-?-BM--Eo-E---o-?--Mo-XMX-o--XXX-o-M-oMEX--BBX-EM-XB?M-?-M?BXo-X?-BX?-M---oB-BM-?oM--X--E-?M-X--MoB?E--BB-o?-?--?--B--M--E--BM----o-M-??-MX-oXMoM-----BMXo--X-oB--MEXB-M-o?
T------MB--M------------M---B-E--oM----M---X-------oEo??------?----X--MoE---oX--?-ME-?EX?-?-?-?-M?-o---BM----------?EM-----o?----M-------o---X-MEBB-X--M--------o----o-o-?--X--oMEX--EX----E----?-?---XE
B-M-E-M--E---o--E---?------E-E?M----M-B-X-----B----E-B-M----E?-oB-B-----M-------MM---E---M-----?---E--X?--------BEo-?o---Moo-o-----X--M?--B----?o---------o--Xo-o----o--E--M-----B--M-Eo---------?----?|
XMMBoX-BM-E--M-------M-o-?-?-----oE-------B----X-----E--o-o-o----M---o---Xo--EXX---o-B--M--M?-----E-M?------X--B-?--M---B?--o-ooM--?-----MB-------X-o---BBM-?-----B-MTo?E--o-X--o--X-B-----?--BXB-oB-?-E
o-EB--M---?--M------oB?----B-B---?M---X-M-BE-M------ME---EMo?--?-----MX-----X-BM--M-X-XB----------o-----o-?--?B?-M----oX----BE----X-EXB?M----MoXM-M-o?-oBEE---X---oEEXo---B-o--o----M----?BM-BB?-oo?---o
|----?E?----Mo-EoX--BoME?----M-----?EX---?M?X?---E----------M--Eo--X--EXB-?----MXX-o??E---BX-E---BMXB---o-B--------XM--??E-X-MX------?B-?-M-E--?--E--oX-Mo--X-------M--MM-o-----o--E?---o----MBM--?----v
o--X-M?--B---B-B--------M--MB-Xo-E---?---oB-------EB-----?-Eo-----M-XXoBB---X---B--M-?---X--o-B-M---To---B-?----E-B--M---?-----X-X-X?-E-EMB--o?o?--oE---E?M-?M----X-o-----o-X---??M--------XEME??----E-T
|----T--T----------?-o----M----?--------X---oMEBMXE-B----o----?B-XB?-E---Mo--o--Bo-----XXMX?B?--B-E-|-?--?-M----M-?---B---M----B---M-?-?----------?----?o------E-M-?-BB-B-------MEM--?M--?-o----?-E-o-EB
?Xo--X--|----X---E--------B-B-XE----?M------TB--o---E-Bo-M--E------oX-M-E--M?-?XE-TX---B-B----?E?--oXB----X-ooX--?E-------T-BEM---?--B--E--oMB-EM-?---E---BB--E---o---MB---X?---Bo---B---?--o-----?----M
E---B-T-|BX--B-------Eo--?E---?-?-M---?E-oXMX------?B?-------MM-o-?------X--oB-B--X-B-?-MB--X----X----?M-B-----------M--?-|---E--o-------E-B---?-o-M--BX-o-------E?X----?XoB----?--X----M?XXooM-B--XT--M
X--E--|-X-------M-----B----B---T-o---X-?-E----X?T-BE-B-oE--?----o-o----EB----?E--E--?----?-------?--B---X-----B---oM---?--X-------oEM--------?X-XEE---??-E-----X----TEM-----X?-M-?--M-XM---B--B--o-o|-XM
--oM--|------EX-EM----BM--o----X--------B-XXX--M|-------------o-----------EoX-----oo?-E----?EX-oX--EEEX----E-?----?E---M----XE-?--o--TM----M-----T-B--?----?----MB-?XT--?----------o--oMo?MB-------o|---
m-----|---T------T-------------T----------------|--------------------------------------------------------------------------------T---|------T----|---T-------------T-|------------------------------|--B
XXXXXXXXXXXXXXXXXXXXXXXXXXXXXXXXXXXXXXXXXXXXXXXXXXXXXXXXXXXXXXXXXXXXXXXXXXXXXXXXXXXXXXXXXXXXXXXXXXXXXXXXXXXXXXXXXXXXXXXXXXXXXXXXXXXXXXXXXXXXXXXXXXXXXXXXXXXXXXXXXXXXXXXXXXXXXXXXXXXXXXXXXXXXXXXXXXXXXXXX
