-----------------------------o------X-----------------------M------E---------------------------------------------?-------------------------------------M------------------------------B----E-X----------
-E-----------------------E-----------B-------E------------------X-------------------------------B-----------o-----X---------E-------------------X--------------------------------------o-------M--------
------------------------------------------M-----B----------------E---o-------o-------------------------------------------------o----------------------------------------------------o-B-E---------------
--------------------------------------------------------------------------------------------------------------E-------------------------------------------X-B--------------E------------------o---------
--------------------------------------M------------------------------------------------------------B-----------------------------------------M------------------------------------------X--------X------
--------------------------------------------------------------------------------------------------------------------------------------------------------?-----------------------------------------------
----------------M------------------------------------X-----------------------------------------------------------------------------EE---M-----------------------------------------------------------X---
--------M-------------------MX--------------------------------------------------------------------o---------M--------?------------------------------------------------?------------------------M-------v
-----------------------?-B-------------------------------B----?-----------------------------B--------------------------------------------------------------------------------B-------------------------f
----------------E------------?---?------------------------------------------------------------------E----------------------------------------------------B-----E-----------------B-----------------X---f
-----------------------M--XX--------------------E---o?----------------------------B----B-X------------B-------------------?-----------------------------------------------------------------o----------f
------------------------------------------------?---o-----------------------------o-------------------------------------B------------------------------E--------------------------B--------------------f
----T-----------------M------------------------------B-----B-------------------------------------------------------------------------------------oX-----------------E--------------------------o-------f
----|------------?-------------------------X------?-----------------------------------------------X---------------E------------------E--------------------------------------------------------------T--f
m---X---------------------XX----X----X----M--------------------X------------M-----------------X--X-X--X---?----?-B-----X---------------------------------------?B----o-----------------X?-------X---X--f
XXXXXXXXXXXXXXXXXXXXXXXXXXXXXXXXXXXXXXXXXXXXXXXXXXXXXXXXXXXXXXXXXXXXXXXXXXXXXXXXXXXXXXXXXXXXXXXXXXXXXXXXXXXXXXXXXXXXXXXXXXXXXXXXXXXXXXXXXXXXXXXXXXXXXXXXXXXXXXXXXXXXXXXXXXXXXXXXXXXXXXXXXXXXXXXXXXXXXXXX
