E?--B-BM?-E-ME-?-E-E------E?B-o-B---MM--BM--oMEMXXX?-B-X-M?o----?-?-ooXXoMMEBM-?-?BE-?-X-oEMME---MEB??-B-XE--E?o?-?-ooXX--XEX-Mo-BXE--E-MEo-MBE-EoEoMB--?-?Bo-?M-BX-B?----EM----Mo------E--o-?-o---E?X??
?o--EEBME-X--B-BM-M-BME-B?-MooE-----XXo-BXEBM-E-Bo-E-?---EBBMo--?MME-??EB----MM--??-MMMo-X---X--ME----?Mo-E?M--oM-Bo-oBBBoX--?-MEX--XEo?EoE----X--B----E----MMo-o-Xo--o--X---E--M-?-E-E?X???---X?-?-EM-T
---MM-oXoBME---B-X-----Bo?Bo---M-?EB----M-X-B-BB-o---?ooEX--?-BXE?M--o-XMEB-B-X-??------E-oE-oEX--?-?BBBBX-------XXBX-X------X-??-XB--X-EM?-M?-?---M?--?-?o-XEX-?B-?BBBMB-EXoX-E?M-E-M?--XXoEXX-?---oE-X
TX-----E--o----------?-o---o---o-----Xo--X--M--??--MM--?E--MM--------M-oEB-o-M----Eo-M?-E--??--?--EoX-E---XXB-XBM----o----o-?-o-MoT-M------XX----------BBX-E----XE-E-E---B-----X----?---M---X----ME-M--o
??---X?---Eo?--X-?X--?o-T--o---EXEo--M---B-X?oB--o-EM-M------X-------o---------X-X----oBE-E-B--?X??-----?--E-?o--?---M---X-B-----?|--X-B--o---X--EoB--E--o?----M-oBEM-----E-Xo-------o---------MB--XE---
?--X---XE--o--T??--EB---|--B-??o--------------E-oB--E----?-?-M-EX--EMB--XM------?-XE-----EB----E--oM-E-----M----BB---BEo-B--oX----|-B?----B-o-E------B--XB-----?-o-B--o--XE-----M?---M-?---X--M--E-o---T
X-BMBo----?-BB|-TXE-----|-T---E---Xo-?---X-o?--------B---?------BXM------?-o---M-?----X-oM--o?X-Mo-ET--oX----E--------M--M---BX-o-|E---BBB-EEM-XE--XB-MT--Mo--EMo--M?o------BBX-Mo--EM--B--?-M-o-E--??-B
T--E-o-o--Eo--|-X------XXXXX--M---B-XT----?-----B----M--ME----M?-M--X--B------oEo---X-E----X-M??---EX--M--M--o--M-MM--oX-E--?-----X--EX----B?-----B--o?XB-E--X---E-----E-------?-------Xo-o--?o-E-----Mv
MX--o-M---o--BXX-X----M?--?B---B-----|o--oBEoXE--------?oMo?E-M-?-----M-----EX---MB---?X?---o--o--------M--o--BE-------??MX-E-MXBo----------M----o------B-----o--M------X-X----M------B-BMM----X--?----|
T-MB-M-??X---o--B-o----M-o----Mo-oM-X|-------M--o-E-X-EBM----M----?--X-?XE??M--MBE--o-------B-X----BM----?o--TEM?--oX--------X-E--?--M--o--E--o-o-----X---M-EMB-XE-----------B-o--X-----M?--MX-----E--MX
T---o-o-?M?-Xo-?---?B---------------E|B-X-----ME--E-------B--o--XB---??o--?---EE-TM----XXXoE---X--?--Bo-B--EE|-B--E--B-X-BX-oEo----E----E--B---oM-B?----o-BBE-B-M-o----B---M?-----EE----?-E--o-o-M-B---|
?o-M-EM-oB-------B--------X?X?----o-TX-B-o--ooo----MBo-B-X----X---MXX-?---E--?---X----XB---B-------E---------X---X------M------------??---M-----B----------o-o--E---------X-----??T-BB-B--B?---Bo---E-?o
o-M---M--?----T-E-B--??----E?EB--?o?X-X---B-oo------?--E-E----------?--XX--?----?o-?---B----oX--B--E----?M----M-----X-X----M--B----X-?---o-ET-X-BBM------TBEM------M-----------E--|---E----------X-----|
MMTX---T-oX--M|-E-E-----B---M---XBM--EMX?X--BB?-----BEM-----?--?----E----------E---o--Mo-M---B--M------o------T-B--B-XE----?MMo------T--X--o|E--E-o-X-X?-|---T----o-o----X--E-----|----B--X-Xo-M-T-o---E
m-|----|--T---|--------T--T-----------------------------------------------------------------------------------|-T--------------------|---T-T|------------|---|------T-------------|---------T-T--|-----|
XXXXXXXXXXXXXXXXXXXXXXXXXXXXXXXXXXXXXXXXXXXXXXXXXXXXXXXXXXXXXXXXXXXXXXXXXXXXXXXXXXXXXXXXXXXXXXXXXXXXXXXXXXXXXXXXXXXXXXXXXXXXXXXXXXXXXXXXXXXXXXXXXXXXXXXXXXXXXXXXXXXXXXXXXXXXXXXXXXXXXXXXXXXXXXXXXXXXXXXX
