-MEX-Xo---MoM---MB-EEEB--??--XBMEM-M-XM-B?--EB?-E?XB-?-E??XMo-XM-?EXo-o-?XMEE-BMBX-B--Mo--o--E-M--MBMoE---oo--EEX-BEE--?-EMEE-?-MB?--T?-MEE?oMEXE-o-BM-------o-oM--oEo-?--M-BMXXBXM-EB?EX??ooX-E-X?Mo--M
MMBX---B----B---B-M?--E-B-B-XX-E-X-E?oE-MoBMo?-X-B--E?E-MTo?X-?---?-Eoo-o-EEBMBXEXBoME--Bo--oXM--E-Boo--oo-X--o-o?-E-B-EXBEX-E-?B--o-|EB---??BM-M?-M?-XE-o-E-EEXM---?EBM-o-EoEX?--X-B-Xo-BB-E--ME----?oT
?--E-BBo?E--BM-----o-----??---o--XM---X-BB--Xo---ooE-X-E?|-?M-?-E-----E?-X--E-----?E-M-EBoB---E--?-B-MEoM?MEEX-M-E?-o---?-?--B-XB-?X-|E-?EXB-B?XE----oM-XM--MBo-------X?-?M--?-o-M-?-XBB--Xo--Mo--M--BEX
X----?o?----B------B-B--X------E--E--o--------M----?o-B--|------E-----?--XX----MB----MBB---?----BX---M-M?---------o--o--?--------TMM-|X?-----?----?---M-----E----ME-XB-----?E-B----EoM??-E---o-----M---X
E--o--o---B-----BB-E---M----M-----B--------M-------M---o-|-------o-X--o--?M------T-M-T---E?M-----ME?----M--MX--E-X--oE--------T--|?-TX?-X-------EX-XX---M-----B-T--o--X-o-----EX-M-E-----?---M-M-B?-MMB?
?-E-X-E-oX---B------X-T--XM------BT--E----?------?----B-?X?Bo---oM-BM-?MoM--X-o--XM-E|M?---?T---EM-------oB---M---?T---?-E-?--X--X--|---??M--M---o-----E--o?o---|E--To--------TMB-------------E------oBo
o--X-E-------BM--?----|----?-?----X---MM-BBoB-?------oMMME-M-X-B---?------o--ME---E?-|-EM-o-X----o-BBX----?-B-oE---|T---------E-----|-E---B----?o-E--B---E-o-?-oX-B-X-M----T--|---------M-E----o?E---MBB
?---T----B--M---BE-------o---oo----M---B-----X---MM-X-M---E?----E--?--E-M--E---B-o-oBX?--B--------B--?---E---o-B---X|XE-------------XEE---?-XE---MBo--B--B--E-M?-oMX-----T-X--|----B-EX--o-M---T--EEo-?v
|B-EXB-----E--MM?o----X-ooM--?--M--?--X---?----MEB---EE-E---?M---?------?o-EXXE------EM?-------BE-?-o--B------------X--??-MX-------o?--EB-M?-----M-oM-EM-?MB?o-------E-?-X----X--XMo-Bo-MM-B---XM------|
M-o?---XX-------B-M---E--o?----?--BB--M--T-XM-?E-?XE-----?EME-------X--BEBo----o--X-----E-BX--o----XMX---?-T--?-ME----o------?-?--M---o---o--B--?--B-B---E--------------o-B--X---E-o-M?M--?-?--Bo----?-B
---?-M-M---MB--M?--------------E-Mo----?BXo---E-B--EM----oo---ooEX?E------ME--X---o--?o--Mo--B-TB-EBEMX---oX-------BXM------X---??--------?--??o---oE-----oo--oB?----BEMB--o?-?T--X-XM------o----oB----T
T-X--E?o--T----M-----?o--M--X------------?-T--B---T--X-?T--?------?T--M-T-----?---o------------T---o----XX--MT?--M-To---B-X-M-?---?-----------E------M-o--------ETM---oo----MT-X-M---?----------M-MX--oB
o---X----T|----o-M-----o--?--M----ooT------|----o-|----M|---To-----|B-M-|o--------?-To-B-----T-|---B---E-----|---B-|-------------------X-----??---?--M-----------|Bo--o------XT-E----o-------M---T-----M
M-T-----T||---------TT---E----------X-X--X?|------|-----|---|-----B|E---|--T--------|E---B---|-|----X-B------|----M|----X?--B-----T------------T--------Xo-------|-------T----|--T-TT---T-E------|----TT
m-|-----|||------TT-||-------T-T---T-------|------|-T---|---|------|T---|--|--------|--------|-|------TT-----|-----|----T-T--T----|------------|-----T--------TTT|------T|----|T-|-||TT-|--------|----||
XXXXXXXXXXXXXXXXXXXXXXXXXXXXXXXXXXXXXXXXXXXXXXXXXXXXXXXXXXXXXXXXXXXXXXXXXXXXXXXXXXXXXXXXXXXXXXXXXXXXXXXXXXXXXXXXXXXXXXXXXXXXXXXXXXXXXXXXXXXXXXXXXXXXXXXXXXXXXXXXXXXXXXXXXXXXXXXXXXXXXXXXXXXXXXXXXXXXXXXX
