-----------------E------------------------------------------------------------------------E-----------M-------------------------------------------E-----------------------------------------------------
------------------------------------------------------------------------------------------X---------MB---------?------------------------?--------------------------------------M------------------------
-----------------------------------------------------------------------------?-------------------------------------------------------E------------------------X----------------------M---E----------X---
---------------------------------M-X----------------------------------oB---------------o-------------X-----------------------------------------------------X--E------------------------------------X-X--
-----------?---B-----------------M-B-------------------------?----------------X------?-M---X-B-------------X-----------------------------------------------------------------------------------M--------
-----------------X-------------------B---E--------------B-B---X-------------X---o------E-----?--E---------?--------o?---------------------B-----B--------------B-B------------------B--------------X----
-----------E-M---------------------------------------o-------------------------------------------------------------------E-----------------?-?--------------X----------E----------------------------X---
-----Bo----?-?-----------------?-?-----------B-----X------------------------------------------------------------------------------X--------------------------o-----------X-----------------------------v
-------o---------------------X-------------------------------------------------X---------------X-------------------------------------------------------------------------B-----------------------------f
---M-------------------------------------------------X-------------B----------------------------------------------------------?------------B-----------------------------------------------------------f
-----------------------------XB---------------E-------E---------------o-----------o------------M----E---------------------------------------E----------------------------M-----------------------------f
----T------X--------------------o-------------------M---------------------------------X-o--------------o------------T---------------------------------------------------?------------------------------T
----|-----------------------------M--?---M-------------------o-X----T--------------------------X-----------?--------|---M----------------------------------------------------------?------?------------|
-B--|-----------------T---------------------------------------M-----|-------?-------------------E--------------T----|-------------T-T---------------------------T----------------------E---------------|
m---|----------T------|---------------------------------------------|-------------------------------------T-T-T|----|--------T----|-|---------------------------|--------------------------------------|
XXXXXXXXXXXXXXXXXXXXXXXXXXXXXXXXXXXXXXXXXXXXXXXXXXXXXXXXXXXXXXXXXXXXXXXXXXXXXXXXXXXXXXXXXXXXXXXXXXXXXXXXXXXXXXXXXXXXXXXXXXXXXXXXXXXXXXXXXXXXXXXXXXXXXXXXXXXXXXXXXXXXXXXXXXXXXXXXXXXXXXXXXXXXXXXXXXXXXXXX
