-XEMXE-XM-BoE-XM?EEMoo---B--o?XE---X--XEX-MEBX-X??XBX--E-oBB--XXB--Bo---E?-o-MXEoM--oB?---MoMoE-oMo?-EBE-B---EBXB-BBo---B--X-Xo-BB??o---?M?-E--EB?M-M?M-oB-oBo?-----BBX-o-X--Xo?E--B--?Eo-MBXXE-?-MM?EX-
X?-oB-B-?X-E--M-oX?o--M--o-?-M?EXEo-?MBMB---E-M--MXoB-X?EM-?-?XXEE--??M--?--XEB--E-B--M-Moo------BT-o--B-B---oBMBE-BEo---E-M?B-oME-Xo-X-EE?--EMo?-MEoM?-B--E-XBM---oMo-M-?oMB---o?---o--MMXXM-oE-EEo??-o
|XX?----E--M--E-M-?oX-M?Eo--B--B-B---M-X?-?XE-BoM-E-MEEM--o-o--E-----M---------E-E--MXB--M?-?--??-|o?-EM?-M-??-E-?-?-?---E?oTE-X?BX??--o-----Xo-EEB--BM---M--o--X---E--M?X-oo--M-oBX-E-M--?E--oX-?---oo?
oX--?--M-----?----BE---?oX---T--X------E----E-?X---?---?E?--------M------X-X--E-X---X-MM----B----?|o--X--E--X--BEMoM--EEB-B-|----X----X-o----EB-XXT?----TE-M--E-------------E---T-EEX---?M----B----BX--B
--o-B-?--B----B---M--MX-o-X--|---XE---E--X-X----M-X-------?----ET-o----M-MMM?XMX-----?--B-BEoE---B|----XXME--M---oBE-------E|--M-E-o-oEX-?--------|-EEXo|?--X--MB--X-----XM-o---|--?-BEEo-?o------E----|
M-M--------B----MM---?-M-ETX-|--Xo-T-?-M--?--X--E---X-B--X?--o?-X-ME-------E----M---E------M-BX--EXE---M-----?-B-o-EMX-?o--BX-?ME-M------E---E---MX---?-|-B--X-oB-?-?---X---M---|M-EoE----o-----?-------
E--o-M----?--X-----EXB--X-|--|----M|---o??------o--X------BM---o------M-E---E---T?o---o---M---T-E--T-----X----E--EBM--M--?-M------?-------X------?---X--XM-B-BM----BT--BBE-B----X----?-B-M-----?-M----X|
|E-?-B--o------X?E--?-----|--XX---E|X-o?--E----M--M-E-E----??---M------?M-M?--X-|--------T-BM-XB--oX------E--E-----B-----X---------B--M---E-E-B?---TM-----BB-M?-----|-------B--X----o----B---B---E-----v
-M------E-??X-o-------M-?-|?-o?--X-|----o--XE-?-E----E-B-------------X-MB?E----oX-?-EE---|---??------E-----o-----Bo------E---o----X-?---o-E-----M--|--?-?-------?X--|-oo---o----X--X---o?BXE---E-E--X--B
|-----?-B-B--B------o-----Xo----MMoX-E-EM--------------BM-oE--E--E-E---B--M---------EBB--XE-B-?BETE-o-----oETB-B-oo---X---XM--E-M----MT------------X---------E----M-|--oX---M--T--o-B?---o-M--------E--?
MEE--X-X---EoE-B--X-M---?-------?------o??--o---oB--X----oB-----?Eo?---o-o-X-B-MB----------B--?-o|?---BB---oXE?M--oooB-BM----EBE------X---oX---X--oBX-o--M----M-?--?X------X-X-|B--XE--M-BMo?---M-B-?B-M
MBE----?--M-----------?--------E-M--TB-------T-X----?-EE---T-M--------o--oM--------MMBE---oM---E-X----o--------?-o--oT----M-TB-oTM--?-M--?---oB---T------T--E---------T----E-oE|--?-?--E-T-------M---T-M
X--o----X-M--------E---M---o--X-MM--|-M---X--|o------oB----|-----T-o-o-o-----------------M-M-M-BM--------B--MB--??--T|E-----|---|--EB---------X---|Mo----|--------X--o|--M-----X----MoXM-|-T---?-----|-B
M-T------T----X---X---B---------T---|--o-T---|B---T--------|-----|----o-T-------B--------T--T-TM----E-B-?------T----||------|T--|M--T-T------E-?-T|--?---|------------|-------------T----|-|---------|-T
mT|------|----T-T-------------T-|---|----|---|---T|T----T--|-----|----T-|------T--------T|--|-|---T-T----------|----||------||--|T--|-|--------T-||---T--|---T--------|-------------|----|-|T-----T--|-X
XXXXXXXXXXXXXXXXXXXXXXXXXXXXXXXXXXXXXXXXXXXXXXXXXXXXXXXXXXXXXXXXXXXXXXXXXXXXXXXXXXXXXXXXXXXXXXXXXXXXXXXXXXXXXXXXXXXXXXXXXXXXXXXXXXXXXXXXXXXXXXXXXXXXXXXXXXXXXXXXXXXXXXXXXXXXXXXXXXXXXXXXXXXXXXXXXXXXXXXX
