|XXE--o-Bo?-o-?EE--oX--B?--M-M---BoE-XX-Xo-XX--MoX-EMM?----X----?M-MXo-MoEEB--oM-M--o-B-EoMoMM---E--MM--?--?-M?MB-B---Xo-E-?-o-M-B--MEE?-oXE--o--BM?--?---MEM-EX?-XoE-M?EX-M-M-----EBXX-E?EoMMX-B?oB-BXT
|-XoX--XoX-M-?M---EE-E-XXM---?Xo----BBE--M--BB?---E-E-EM---EM-o--X?E--X--o-oM--o---o-X-----?B-EM-B-?XBXX-oEoE-MB-E------oE-MoEM-?--oBMXM-M?-----E--EM-Eo?-?E-M---M-B--o-----EX--B?X??-Xo--------oo---E-|
-E---M-?----o-?--XM?MME-------E?-MX---o--??M-?B-M---EB-?-----E--E--M--?MB--ToMB-B-o----BE--BBM-B--M--Eoo--?o---?MMoE-EEEoXB----TEo-EM--MB--E-?-?---M--EX-?-M--MoXo-M--B----oBB--XEM-MB-o-BX--?BMo-B-X--X
----XB------X-Bo-----BM---E---?E--MM---------o----XM-E-E--E--M---------M--B|B--E?EB----------B--?-X-----------?--MB--T------X--|XE----MX-----B--------?----E-?-o-M-B-XE-MB-XT---T?---------M-M---E?-T---
oX--?T?-E-?-B-----?oXo-XM--o----E--Mo-X--E-X--TM-MB-----oX--------T-----oE-|---EB-----o-M----T----B-E--X??--M?-M--?E-|--X---E--|-E----?B?-----X-B-----M--M------?o-E----E---|BoM|--B--o-X--M--?--o--|-T?
|---o|----E----o----B----B--Mo---o--B?---MoM--|-E--------o--o-?---|-XM-----X--o--X-X--BM--BX-|---------M----M-ooB-E?-X-M-------X-M-o?------E--M?-----Mo-X---T-E-?--o--------X---X-B----o--E-o--o----|-|X
-BX--|o-----?X-?XB-B-X--E----M--?--X--M-------|?M-XM------X-------|o?----?-M-B-M-o-B-?oE-o---XXM---oo-------oB?---o-------XXX--o?-?---B----B--B-------?X-B?B|-?T-M--B-MXEB--o---M-T--?B-----EX---B--|-|o
M-M--X-------?T?-----E--?X-?-----Eo-?------ME-X-M----o?-oT-----?X-|-B?--?-----B--M----o---Bo---T---------MB-M-o--B-----EEo---X------o-----X---B--E----o-----X--|-----B----MX-o---oX----E-X-T-??--BBEX-Xv
E----------X--X--X---M-E?BE--?-o----T--?-BM--X-X-o-E-EB--XBX--o-?-X----------------o-E---XM?---|?-E--o--E-MXBX----B-------------?----E?X-ME--?o----M-M--?-B---?X?X-o-?--?XE---?-MME?EX-----|------B--M--
M---X-----M-----B-----B----B--o?-TX-|-B--BE-------M-T----E---B----BM----o---E--X-?E-?---?------XM--M-M-----?E?B---E-----EBB?-?--Eo-----M-?o--B--E-----E-----T--o------E--------?---E-BoB-B?XB------EME--
T-----oX---?M--?---XB?-?-o-E--B-E|--X--EEB--T-M-B---XoM-B-E---?----------EXX-XM----X--M-?--E-Xo---o---X-?o-M---BB---M-M--MM-X-oEM-M-----MMTo--?-?M---?-----oX-M?------Bo?---X--?--T-B-----M--?--BX-----X
BM?E-X--o--oM---B-M--BM-T-X-X?---X------?---XT-----BoT-----B-----?EE------M-T--E?----XT----B-?--------M---ToM--ooTo-----E---o-----BXB---B-X---BT-T------------o----?-----o--T----T|--B--TB-E-------M---|
-TM---E---E----XM-----TX|---o-B--o------B--X?|T--To--|M------o--------o-?---|------E--|-----T----------T--X------|--M------B-T-EoB-?---T-----X-|B|---E--X--?T--TT------BM---|----||-B---|-------MX------
o|-----------B----T---|-|?-----o----T------?T||--|---|-X-----------E-X-o----|---------|-----|-------B--|---B--T--|----M-----M|-------T-|-M-T---|-|----------X?-||-------T---|----|X----T|--oT---TT------
m|-----------T----|---|T|T----------|-------|||--|---|-T----T----T----------|-----T---|-----|---------T|------|--|---T-T-----|-----T-|T|---|--T|-|-------------||-------|---|----|-----||---|---||TTT--E
XXXXXXXXXXXXXXXXXXXXXXXXXXXXXXXXXXXXXXXXXXXXXXXXXXXXXXXXXXXXXXXXXXXXXXXXXXXXXXXXXXXXXXXXXXXXXXXXXXXXXXXXXXXXXXXXXXXXXXXXXXXXXXXXXXXXXXXXXXXXXXXXXXXXXXXXXXXXXXXXXXXXXXXXXXXXXXXXXXXXXXXXXXXXXXXXXXXXXXXX
