TBE?o-??--B--?-XE---?--?--B-XoE-?M?B----BE--E-?B?XoX-EoX?-?-X-E----M-MXEX-B?-----??X?BM-ooX---oB??-o?-oMM-oM-MB-B---BBE-XEBME-oX-E-?-E--X----XXooXEBMX?-o---MM-MM---E--o?---BXE-MoB--M?-BoXXoEMBoM--?X??
M-EB-MM--MB-BM-BM-BoE-E?oB-E-XE?XoE----o-M--?BMM-----?E--?XMM-B---oo-E-----MBMX-ooE--oXE-EXEEEBM-EMEE--oM-BoME-oMM--XXo-X--BMM---oM----E-?B-oXE--E-?Xo-XM-E-BE-?B---o?XX----?-BXoB?XBEoX-----XB-BM--ME-M
-B-M-----oB---?EX-oX-o--BX--E?--M-Xo?E-XB-X?---?ME?Bo?-MEM-E---o--oBBMM-?-XE-M--?--oo-o-X---B-X?MM-EE-B-XBEMX--EBB---?--X-oBE----?----o-EB--?EE-ME?o-oXB---XBE-BMo??M-MM---M-------X?-MEX-X--X-MX-XXMB-M
E---M---?--B-B-X?B--M--M--?-X--------?-E-------?-M-oo-E------E---o-MX--E-B-?X-MM-------ooB?---EE?-MTB---EE--M---B-E-EEX-X---E--o-B------?-X-M---o-o--M----X---X------M-----?----?----------o-E-----MBo-T
Mo----?X--o---o-T-oX-?o------?BB-E--?---o-?-o---M----X?-M---X-?--BB-?---o-X-M-o?B----MB--BEX------XXo-B-?Bo-----BBMEo---M----M--E---??M---B---EM--M-X--T--T-E--E----------------?---B-BXMMX-E----T---MMB
|o--MX-M--E--B--|--E--Eo?-B-MM?MM---B------X?EXET--X-o-o-------o--M----B----B--Bo----o---o?---o--E-EM--?E?M??------o-----B-Bo------BT-B-B--ooX--E--?-XXX?-X----oX?-E-E----B-o-E-----?--E--E-----B|EB---M
E---?--XXB--?---X?-----Eo----B-B--B----??---B??-XoM---------T-oB---?-M-Mo--?---------E--X-?-----?--------oo----M----?----M---E-MB-o-Xo-------o--E?-M-MB--EB-o----E-BM---X-M-oM-XE?----M-B?EM--XooXB----o
---E-XM-----T-o-----X--B-?-o-------?-oEB------------o----?--X-ooXoo-X-----B---o-----------?-ooE-----M----EB---M-B-----E-o----E?--o-M--?--oEX---EMMB-Xo---o------M-E--o--Bo---T-MB-E-----B--B-oB-?------v
Mo-M-Bo---B-|-E--o---o------??------X----T--MM-----?-E?-X?--?---o--X--B------E-B---T--------?-EB------E?---?-M--B--EM-o?o----o-X-E------?-------B-?X--BE--E---X---oB--Eoo---B|o-EEM---------E-?X-XE-B--?
E--oo--X---?X---------Eoo-ME---M---X?--M-|--------M-E--B--BX------E--B-------M-M--o|--Bo--E--X?E??--X?--XE-M?BE--M-oEM---?--E--BoEX--?B---?--o?---B--M?------o-Xo--------oM--|-------BB-X--M--o---EE-?MT
T-----B-M-?o-B------B-------EX-?-X-o?----|----EE--B---M-E-?--X--B--E---E--X-BM-----|X----M--B--?--o-M---?M-----o----oM--o---E--EM--E-M---M---?-XXB-------EE-?---M--X---------Xo----E-o?-?-M----E--?--o-T
T--X-M--BXM--MM------?Eo-EX-M?ME--M-o----|M-X-M?E--E-----TM-TM-MMM--E--B--B----?-X-X-------?-B-o------B-B--X-Bo-MM---o-B-----BM--E--o--MXMX--E---M--?-B----B----B-?-M-------M---?M--X--o-E-------X?M---o
?---?E---?----B---MMX--?-?-M-?----ooMM---X-E-?o-oM----M--|o-Xooo-?---------MX-TM-MX-X?-------o-------M-M----M----Eo--Mo-E-?M---M?E---?--E-oE---Mo--X-M-ME-X---o-ooo-------o----?--?-?--oMM-B-E-XB----MXM
B-----X-------M--oMoo-X--Mo--?----E--E--?B--oBM--o------o|------E-E------B--o-|--EE--??-B---E-ME---oM-X?-XX-o---o-----E------o-?B-M-M-oXB--B----?M-----E-E----BX----B-?------E-?----E--?-M-TEBX?o--M--?E
mEoEM--?XXMMX----oo-oX--oB--??MEEE-XXo?-??EM----MEoXo-EXBXM?E-BXEM-X-o?-E-MEBBXM-E--XB-X--X--o--B---B?B--o---oBoXX--M----?E-MEo-MX-M-o--BXM-MX-o--BE-XBM-----XEMo-M-BM-EE---M?-B?-X-B----BBXoo--o?-ME--X
XXXXXXXXXXXXXXXXXXXXXXXXXXXXXXXXXXXXXXXXXXXXXXXXXXXXXXXXXXXXXXXXXXXXXXXXXXXXXXXXXXXXXXXXXXXXXXXXXXXXXXXXXXXXXXXXXXXXXXXXXXXXXXXXXXXXXXXXXXXXXXXXXXXXXXXXXXXXXXXXXXXXXXXXXXXXXXXXXXXXXXXXXXXXXXXXXXXXXXXX
