oEoE-?--E--?o-XB-XMBo---E--MX--?-B--M-E-?E?-o--M-X---??--XB-ooEX?MM-MB-oEM-XB---B-MXX----o---B-E-BM-o-MM--oB--E-o-M?--EEM-o?----------EXBM---?XEEEo-EM-E--?o--?--X-o?B-?-Xoo--E-M-MBo-M-M-EMBMXM-B-o-MTX
XoBX-------E-oMXo-B-EMX-o?X---MXX??-X----M--B---Bo--BXBoEX--o--X-BM-MMB-BoXEM-XBE--?--M-E-----o-B?E-B--?--XB-MBoXB?M-M-B-Bo-?X-?-o----Eo-XB-Mo?B-EBEXEooM--EBEMo--?BB-?-?B-?E-oXoMX--MXE----M?B-Eo?EX-||
EEMX?-X-ooEBMMX----?--o-o-----B-MEBB-ME-BE-X-o-M-E----?--X--B---?E--X-BEo--M-Xoo--?B-?-oo--EBB----oBMM---o-M?-?Bo--Bo--M--BMEEXM--?B-o?--?E--X-E-EB?-E-----XXB--X-XM-------?-?-B-?EoB-X----M-B----oBXo|X
oE?B--X---X-T---------?-----BT---------?-B-oB-B-----?--o--o-B--E--X----XX-Bo--?-M--E---------------?-E------E-oB---?---------------E-oo-?X----X--X-M--X---ME?------M--o---B-MoM--X--X---MX-EM-------?-|T
o?B-E-------|------M---------X-B--?---o----------o---M?-?EB-E---o-------?X--o-----X-------X--E-B-------o--Mo-X------?M?M?-oX?---X-MBX-----------o------M-T-M--Eo--------X?---BE--E-X-MX----?--?----E--Xo
B-E-?----X-?X-B-Xo-o--------XBM---?-XB----X--M--?---------o----o----E--MEE------------E--B----?-M--XMT--X--M-----------E-M?---M---E---E-TB--?-----o---M--|---B--?M-EX---o--X-E------E---------?-XB--?--o
MB--BEo?------E??M----E-?o--M-B------Eo?-E---------o?-E-B-----B---------o??-EB--X-B---o---X--M--?o-M-X-E??M----B?---?-?------M--oo--MX-M|--M--X-----?----|-?---M------M-----?M--?--M----T-o----XB------E
Eo-?o---?----M-----Xo-T--o-o-o-B-----------o---BM--EM?-------M----M-?--X-M---E-?Bo---B----o---?--?B-E--B-oo------B---?----B-B-?-E----?oo|X-B--?B-B---M-BXX?-X--o------E-----------------|--T?---BM-----v
M--BE----X-----BE--B--XT---?---o--M?--B--o---E----B--E--XXXo-E-X-?-Bo-B----------------------XT-B------E------?M?-EoX-----?-------M-MB-M|?EM?--?E?TXo-B---B-----M--o--Bo---B--M----E---MX--|Eo?-M----X-M
B--o-------------o-----XM----o--------?---oM---E?B?-----B-----MB-----------o-?---E-E--------X-|--?--E---------E-E--B-------BX--M------??X-MB---M-?|?---o-M------?-X----oT-Boo---M---E----?-|--MM---M-T-E
--?----X-o--B---M--M-----------E-X-----o-Bo---X-E-E----E--oEE?---E---X---?------B----XBE-B----X-E--MB----B---X---?B--BMXE-BM-X?M---?M----o--------X-B-X------------ME-?-X--M-----?--T-o----XX----T---XM-
M---?-----TB-E-Mo-----------o--oE----MT--M-Xo----------E-X-M-MB------?--??--M----X------T?------?-X--MM-----?-----?------X----?------------o-----o-------EXE-B-----------o-----B---EX---T-----o--X-o--M?
o-TB-X---X|-X--?------X--M----?-------|----o-o-------o----??------T---X-?-T--------X----|TX----o--------?------?T----E-BX--o--T--o-MM-----T-------------T-T-?-----ETo---------E--Xo--?--|T-----B-M--XM-T
|-|-------|B--X-----??-----T-------T--|T------------T-To-----TT---|-------|-TT-T----T-o-||T--X-----T-------E-E--|-------------|-T---?-o---|-------------|-XEEo----E|--------X?T-T?-----T||---M-T------T|
m-|---T---|--T-------------|-T----T|--||T--T--------|-|------||T--|-------|-||-|----|---|||-T------|--T------T--|---T------T--|-|---------|-------------|-T--------|--T-------|-|-T----|||-----|----T-|T
XXXXXXXXXXXXXXXXXXXXXXXXXXXXXXXXXXXXXXXXXXXXXXXXXXXXXXXXXXXXXXXXXXXXXXXXXXXXXXXXXXXXXXXXXXXXXXXXXXXXXXXXXXXXXXXXXXXXXXXXXXXXXXXXXXXXXXXXXXXXXXXXXXXXXXXXXXXXXXXXXXXXXXXXXXXXXXXXXXXXXXXXXXXXXXXXXXXXXXXX
