E-oo-B-M-?BoE-MB?-EE?BE-??M-?-EB?-BM---X?---?o-Eo-?EXoB--?B-X-M-MXo--M?---MBE---o-----?XX-o--M-?-o--XEMooBM-?XBBXM--B?Bo-MBoM-M-ME--M-MoX?BX--B-BE--?B?-E---?----B--E-XM--M-X??BBoXX-o-M-BM?-XB-B---M-EB
o--o--EX--X-M-BEM---XX-TXM-XEMBMEoXE?-M--XM-M-M-o-?Eo--?-EME-ME?MBM?MMEXEX--MBXMB-BXXoBo--X----o-M?---?M--B?MMEM--B?XoXo?--???E?oooM-?-E-------EM-BoE??-M--ME----XM?-Xo---M-?-XBMoM-E---o-?-??--?o-B--Eo
X--?o-MXMoo---?--BXo-X-|-XMM--B-Xoo-o---XE-?-M----------?X--X------o---?--T?o--?---B-Mo----Xo?-B---E-M??-?--Eo-X-X-oBBBo----?MXB---X-B-----X?EB--?BB-?-XT-o-M---?oX?EEX-ME-XBXoXo---XE---o------E---oB??
--?-o----E--EXX--M-oB--|-------oM--EX-?--BE---?--------?-----?B---?-Eoo-E-|---Xo-----E--Xo--B--BX--X--------EoX--E--E----B-o?-?--X-----Xo--------?-MB-E-|-------M-----?-B-Bo--B------BEB----MBBX-M---?-E
To---XMX?T-----BX-E---EXX-XoBX?---EE-MBoE--E----T----oTB-?o------T?E---M-oXB--o--o-------?B----B--B-TT----E----BB-------XBo---BE-B--------?B-?X------?--|X-o-MX----X---E--M----E--o------E----?-----M-BB
o---?-E--X-X---EB--X-X-------M-X----EoM--B-ET---X-M-M-|-E?E--MM--|----X-----o----?--------M-------M-||-X---MM----T-X-----o--M---o----XoEB---TEB--E?-MB?-|--T--B-M---EM-o-----M---TM---o-------E---X-M--E
-ME----M------------X-E-o-M?--------o-M-----|--??----M|E-oMo---X-X---X-M-----------B-----E--?--?--?-XX--M--------X----Eo---BoX-o-To-o?--M--B|oM------E--X-X|--o--XT----o---X----?|M--E-------o---------X
B--E--T-o----BXB-------B-E-Eo-E--------M-M-X|---B-X-M-|E--?----o?-------?--?o?MXB---M--o-?B-----o--?-----B-B-M--X-X----E-X-?--B-?|MX?o-Xo---|-?--E-E---MM-MX--B---TE------XoB---?X-o-?---XB-E-?XEEB-EE-v
B----MX---o--B----B--------M------T----?M---|--X-?---XXo-MM--XB-----Xo-M---B------E-oXX-XB--MBX-o-XoMo----EE?E-o-------?--E-M-M-?|o-B---M-E?|------o?--Eo--E-?-XM-|----XEo-E-----EX----o-E---B-?----M-MT
o-X--M---------X-M---oo-X-M---o-M-X--XE-----XB-----o-E-E-B-E--o----?-ME-E-----------------E---------?----------o??---------TB--X-|--?BE-?-E-X-----?E--oB-B------E-|-XEMBM-B------EB----oT?MoM-M--------?
E-?---E-?-B--?-o--?-B--o-E--X-E-EM---E-------EME---------B----------o------X-E---?---X-M---oME-?X---BoX---X-ooM--B-----ME--|-oo--X-X------?-?---E--MM--B-----B-?-?X---E-B?-o--o?--M--BX-|---o-M---EX-o--
T-------------?---------------EoMT----E---?----------o-----------B----X---?--o?--T-X--M-------M----------------------oB--M-X----XE--E?ETT--------------T?--E--X--?---?----T--B-o--?---?oX-E-----TX----TX
M--M-----M--EMM--X---------------|----------?------B--B--?E--T--o--E--?XT-------TX-TB-----M----E-EX----oX------o-Eo---MM----o--M-------||--?--Bo-----X-|--E--B-X--Eo-T---T|-----M-E-o--?--E?--B?|M-X--|T
o?X---------T----------T---------|--------B-T---------T-M----|-T---T----|-XB---T|--|---------T--------------XT-------------X-TT----o---||----?--T-MT?--|------------o|--B||-----------T--M------|---TT|?
m-TT----T---|-----T----|T-T------|T--T------|---T-----|---T-T|T|---|----|--T---||--|---------|---T----T------|--T-TT--------T||T-T-T---||-----TT|--|T--|-------------|---||------T----|--------T|T--|||E
XXXXXXXXXXXXXXXXXXXXXXXXXXXXXXXXXXXXXXXXXXXXXXXXXXXXXXXXXXXXXXXXXXXXXXXXXXXXXXXXXXXXXXXXXXXXXXXXXXXXXXXXXXXXXXXXXXXXXXXXXXXXXXXXXXXXXXXXXXXXXXXXXXXXXXXXXXXXXXXXXXXXXXXXXXXXXXXXXXXXXXXXXXXXXXXXXXXXXXXX
