X-MM--XB-?-MXoM-XXX-?E-M-E-?MB?BoX-E?---?oB?X?XoX--E--oE--B---o-M--?Xo--B--BM??o--?--EE-MX----XM--o-BE?-BX-oMMBB?--o-----E-?---??---?-oM--EM-EMoBMo?oEo--B?oX-oE-X-MM?-o-ME-?BEX-BMB?-MM?oB--XXXB-?XM--|
E-X-?--X?EXMB---?-Moo?----EX-E-?-BE--EM?--BXE?E-----XXX--E-oX----E-TM-M-o?-?---M-o-o--X-EXXM-?---B?-BEM-E-M--M-Mo-B-X-E-E?-B-o--?XE-----MM-EM--ooE-oE?o--M-MBME?--M-T-oo?oBX-X----Moo----E?BE---?E-?BXBM
ET--oX-M-o-M?--o---o-M--X--?--MMX-M??----?BMMooMMo--XXEooBEE-------|E---?E-----E?-oM-oB-E----M-oo--Mo-XX-XB----BE--E---B---MB-B--oBX?X-BXo--EX---?----E-E----M--o-Mo|--E---B---oX?E--B--B-X-XE--E-----XT
||-BT--ME----B-----B-X-M-----o-o-M--XE-B--?--M---?---M--M-o---?--o-|M-------------M-Eo--?--------B--BX----oMXE----Eo---------XM------------E-B-T-E----E-----X-----o-|?-E------B-B-B--M----E--EEo---B---?
M|-o|--o---B----B--?-----X?---M--BX-?-----M?X-------X-o-BE-B?o--o--X-X-------M---------M---EMEME-E-o-BX-----E-----------------EX------EMEX-----|-----B--------?-M--B|-XTEo------o?o----B-X---B-M-?--?-EX
MXB-|---XM-M-?-----B---XX---T-------?--X--BM--oB-??---o---------B-E?-?-X-X--B--B?----E----?----M-o--o?E-M----M-----X-X-----o-o-T--XX-X--M--E---|--?oB--TMB----M-M--MXEBX----?-E-?M-o---E-----M-M-----BoX
B---XB---TM-oM-----M-Mo-E---|-B-B---M-Bo--B-----ME-o?--X-E---M-------oEo-?---oo--X?-E------X---MMM-----o-M-oE----M------E----?-|--o-o---M----M-X--?-B--|---E-T---o?-------X-----E----XX--oB--------X---M
M-?-o----|------?--X--B-MXoB|-------?----------E---------B------M-BE-?-B-E--?T-----?--B-X-E--X??--?Bo--?-----BEEM------E-B--o--|?B--oE---E-----T-------X-XM--X-E--B-M--XE-o?o-------------E-EB-oBB-o---v
BT---X---|--X----BX-X------BX-----------Mo-?oM---T-oB---o-X?-XB--XMM-M------MX--X--o----EB----B---------?T--E-M----B-B--o-?----|-o-E-B--T--T--X|-X-o-?X-oo--X-?-?--X--E-----B--M--E--------X------o----X
?XM-?M-?-|---BX---?---------B----------EM--o??---|B?-M-X?-M--------MM-X-XEBM------M-------?-----BE-o--o--X-o-----------?---E---XM-X-----XX-X---X-M-?---o-------B-E?--X--oXM-------EX-o---X--MX-M-?M-E-?o
X-oM--X--X--M--o--?---M-------ETB-----M--oX-EM---|----M----E-------?oE-----MM----M-o-B-o-----M?EMo--B--M-o?-BBM----EoB-B----?M--B-----B------?-E---?-----E-?o-X---oBB-M-?-o---X---E--B------B----oBE---T
|----------?-XoT------------B--X-----------o-----XE--?--o---XM-BM-X-M-----BB--??M--E--X-T--B----M-------oo-----B------M--EM-----o---------o-M----B-----Eoo-----?--------?----T--------E---E------o-BTM-o
X--MB-X----o--?|---o--------------XoB-----------M-M----B-X--TE?-------------M-E-ToBT?-B-|--B--T--------o-------o--X-M---B-E-----B----M---B--------T---o-----B----E--T-B------|-T-----M----?----?--TE|o-|
B-----E---E----|----T----T--------T---T--------------?--M---|-?--------B--BT-M--|--|----|-----|---X----T------------?---T-T-T------------?-M-----B|o---------T---T--|-T-----T|?|---X?-T-T-----o---X-|--o
mT----T--------|---T|T---|-----T--|---|---TT----TTT-----T---|T----TT-------|----|--|T---|-----|TT-T----|------T---------|-|-|T-----T--T-----------|--T-------|TTT|--|-|T----||-|------|T|---------T-|--o
XXXXXXXXXXXXXXXXXXXXXXXXXXXXXXXXXXXXXXXXXXXXXXXXXXXXXXXXXXXXXXXXXXXXXXXXXXXXXXXXXXXXXXXXXXXXXXXXXXXXXXXXXXXXXXXXXXXXXXXXXXXXXXXXXXXXXXXXXXXXXXXXXXXXXXXXXXXXXXXXXXXXXXXXXXXXXXXXXXXXXXXXXXXXXXXXXXXXXXXX
