E-oE?---o--M-XX--B?M?MM--XX-XX-?--X?-MEoo?-E-M?-Bo-MBM--BBM-?B-?Mo---B-o-X--E-MB?---o?-?-E--?B--?M--o-M?X?B-BEMBEo--MXo?E?B?oX?XBM---EX?-ooX-MEE-M-EMooXXE----M--B--E?BMo--B-?EE?-XB--B-M---?E-?M-Bo----
?Eo-E-ooMMX-----E---EX--??M-BoM--?X-o--??XXo?-o--?oEX------E-EoBBB--X--E----M---MEoMoM--EEMo--BX--o-B?-o----B-BM------XE--Bo--MM-BX-EMBM--oE---?ME-XoB--XB?E-X--BBoo--X--X?-o--MBE--?---EM---B-B--X--o-|
B--?-----o---X--M----B--?-oXXo-?--E--B--EM-M--?BE--o----oB-EBBMM---EEE--X----B?o---Eo-?MB-X-BEM-?--EB--EB-o-E--B?-X--XBM-BoX---?M---M---oo-B-B-o--??o?--o---BX--X-X?EMX-B-XE-MB-EM--E--EB-o-E--B?----Xoo
E--EM----o--MEBB---M-----B-E---o----?M-XXX-----o-----B-ME--T-M-----E---B--X-Eo-MoB--o----B---EEo-B-M-E------B-B----o--M-----M------?-M-M-----M-?-?X------X-----M--o--XX-----ET--M--X-o-X-------M--oM?--E
M-X?-?MX-?------XM-EBE?-----------EM--o-----B----BEM--X?E--XX----M-B-EX-----M---B--B---B--------M--E--E---XE---E---------M--?--X------B--EB-X-o--M----o---M--o-o-X-----??----|oBoE-T----?o-----B?-----MB
E-M-----T-E?-Mo-ooo-B----BEMMBM--X---E-o-o---?--E--------oE----M----X----EEX--------------M---M-E-X-ME-MXB--B-EoBM--XX-B--oX---o----o---M-?----B---?Bo?--o----M-M----B-EBo--oX-----XTX---EE---o-B--Xo-?X
T--MTB--XXMB-T----To?----M--E-E--M--BE-----o--X-T-TX-M--B-B-MM-B-o---?o-----X----X---o-?T-M-X----X-M-B-----M------B---BM----o-------B-oT-X--?-?-M---o------o??-??E?--EB-MoX-----?---|------X-----X---o-B
E---|-B--M-E--X?--XM-------?---X-M-----o----M-ME|-|-o?-----E----------?---E---?-----B?Bo|----B-----Bo-?--M-?----BBMEE-o?------o-------oXM-M-----B--X--oB-----E-B--------B------o--M-|-E---Bo-BB-X?X-MB-v
oE--X?-oXE-o-X-?X--M-----?--X--oBBMB--EE-o--T---Xo|-?M?--Eo--------B---XoX---E--?-----M-X------o----EB-M-o-M------o---------XXE----EM---E----XX-?---?T---MEM-------?B-X--?BE-----B?-X-BBE------------?-X
?E--Eo-B-E--Eo--oTE?----o--T--E----M?------BXX--BBX--BT----------?--------M---M-----??--B--E?B--X---EoB---------X---?---M----E---M----X-M---oE?-M--X-|-B-?--X--E?-T------------oT?---?EE----M?-E?T-??--B
-B---B-E------o-MX-?--XEo-X|------o-B---B--E----Mo---M|M-o---E----BM--M?---E---X--o--E----B---BMo-Eo--B---o---B-o-B-MX-------M-X--XT--B--E----??o----X---?-B--XoM-X?---o-Bo--?-o|--B--o-o--M--oB-X-----?
T--?-----------BT-M-B-----?X---o---X--------B--B----?-X-------X-------B---E---T-B-?X--o-----------M---B-----XX?----T---M-T---------|--T-----T--M----E-?M--?---M--M?----?------BBX----o---T-?-?-----?---|
B-T-------?-----|----------------X-B-?----M---E-----o--E--------------M--B----|-M----?-X---EX-X--EB--------TE-oo---|--T-X|-Mo------X--|-XB-B|--o-MXB----oT----T----o-T---BB---------X----|o--o---------E
M-|M-X----o-----|-------T-----T----------oo---------T----------------------TT-|--M-------T--oo?-----------TX-T--X--|--|--|-E--T------T|--o-T|---M--------|---T|------|T--T---------T-T--E|T-?--T-------X
m-|-------------|T------|----T|----------T---T--T---|T------T----T---------||-|----------|------T------T--|T-|--T--|T-|--|----|T-----||----||-----T------|---||------||-T|T----T---|-|---||--T-|-------B
XXXXXXXXXXXXXXXXXXXXXXXXXXXXXXXXXXXXXXXXXXXXXXXXXXXXXXXXXXXXXXXXXXXXXXXXXXXXXXXXXXXXXXXXXXXXXXXXXXXXXXXXXXXXXXXXXXXXXXXXXXXXXXXXXXXXXXXXXXXXXXXXXXXXXXXXXXXXXXXXXXXXXXXXXXXXXXXXXXXXXXXXXXXXXXXXXXXXXXXX
