-------------X--XB--------------------------------?---------M----------------------M--X----------------------------------?--M---------E-------------------------?-----------------------------------X---
-------------------------------?-----------------------XXXo--------------XXX---------------o---?--------o------------B-B------------M-------------------------XB-----------------------------------X----
-----------E-------o----------B----------------------------------------X-----------E----------------------------------------B-------------------------------------------------M-------------------------
-------------------------------------M----------------E------------------------------------------------------B------X--------------------------M------M------------------?--------B------------?---B----
-----------------X-------------------------------------o------------------------------------------------------------------------------------------------------------------------------------------------
---------------XXE----------------------------------X------------------------------------------------------------B---------------E----------------------------------------------------M-------------o---
---------------------------------------------------?-----------------------------------M-?------------------------------------E---------------------B---------------------------------------------------
--------M----------------------------T--B------------------------------------------------------------------------M-------------------B----------------------M----------------------------------------M-v
------------------------------------?X-----------?--------------------E--------?---------------X---------E-------o------------------------------------------------------------o--o------------------o--f
------------------------------------------------------------------------o-------------------------------?---E-MB--E-----M----------------------M-------------------------------------------------------f
------------------X-----------------------------------o----------------------------------------------------------?--------------------------------B---------------------------------------B----------X-f
------------------o---------------------------------------------------------------?--------o--------------o---------------------------------------M-X-------------------------B------------------------f
-----------------------------------------------------B-------------------------------------------------?------o------M-------------------------?-------------------------------------------------------f
------?-----T---------------------------------------------------------------------------------------------------------------------------------------------------X-------T-----------T------------------f
m--X--------X----B--X-----------X-------XX------------X----------o--------X-X----XB--X-M----------M-------M-----------X----XX-E-X-----------B----------X--------B-X-----X--------X--X----------?--B-X--f
XXXXXXXXXXXXXXXXXXXXXXXXXXXXXXXXXXXXXXXXXXXXXXXXXXXXXXXXXXXXXXXXXXXXXXXXXXXXXXXXXXXXXXXXXXXXXXXXXXXXXXXXXXXXXXXXXXXXXXXXXXXXXXXXXXXXXXXXXXXXXXXXXXXXXXXXXXXXXXXXXXXXXXXXXXXXXXXXXXXXXXXXXXXXXXXXXXXXXXXX
