------------------------------------X--X-----------------------------------------------------M-----MXX----------------------------------------------------------X?---------------------------------B----
---------------M-------------------------B-------------------------------------B-------------------M-------------------------------------------------M-o-----------------------------X-------------B----
-----------------------------------------------------------------------------------------?--------E-----------------------------------------------------------------------------------------------------
-------------------------------E--------------------------------------------------E----------------------------------------?----------------E-----------------------------------------------------------
-----M------------------------------------------?---------------------------------------------B---------------X?-----------------------?---X--------------------------------------E---------------------
---------------B-----------------------------o-----------------------------------E------------------------------------------------------E----------------?----------------------------------------------
---M--------------M-------------X--------------------------------------X-o-----------------------------------------------B---E-----------------------------------T--------------------------------------
----------------------------?------------------------------------------------------------X----------------M---------E-------------------E-------o----------------|-------------------------------------v
-----------------------------------------------B----------B------------------B-B----------E--------------------------X-------------------------------------------|------o----------------E-------------f
-------------X----T------------EX---------------------------M-X-------------------------B-----XX-------------------BBE------------------------------------T------XB---------------------------------X--f
------------oB----|---------?------------------------E----------------------------------------------------------------------------------------------------|--------------------------------------------f
------------------|-----E----------------------------------B---------------------------------------o---------------------------------------------BM-------X------------o-----------------------------T-f
--?---------------X------------------------o---------------------------------------------?------------------------------------------------------------------------E--T--------------------------M--X-|-f
-----------------------------------X-------------------------------------------------------------M----------------------------------------------X----------------X---X-------------------------------X-f
mX-M------------------X---------X---------XX---X---X-XX---X-----X----X--X----X---------XX--X-X-------o---------------X------X---------X--------B------X-----------X-X--------------------------oX------f
XXXXXXXXXXXXXXXXXXXXXXXXXXXXXXXXXXXXXXXXXXXXXXXXXXXXXXXXXXXXXXXXXXXXXXXXXXXXXXXXXXXXXXXXXXXXXXXXXXXXXXXXXXXXXXXXXXXXXXXXXXXXXXXXXXXXXXXXXXXXXXXXXXXXXXXXXXXXXXXXXXXXXXXXXXXXXXXXXXXXXXXXXXXXXXXXXXXXXXXX
