|XEE-M?ooE-Bo-EooXX-E?E-----M---MM-?EX----o-B?-B-Mo-XX???X?---o?B-?-MMX?oMM?X-?-o-MB?E?EE?E--oXo---M-------MM--o-M-?o--oE-B--E---o--Bo-?-Eo?--?MXE-MXX-?-X-BM-o?X--B--?o-B--?-EBE----BEM?-MX-oE----X?B-?
oM---E---EBM------o-X-XXM-E?-?M-BoM??-?-?M?-?-XoE--BM-E---BXX-B?B---EM-B-??Xo--XME---XoM---o---o-Mo---E-M----EX----M---EBEo--E---XB--?-E-?---MB---X-M??BXME--ooBoMoE-?BXM---o-?E-E-MB---EB-X?BMXo-?-oX-X
B--MB-EB-BX-M?E?---oMEBo---M-M?X-B-Boo---o--o-oBXoB-oo-?B?-EXXEB?--M--??EBoX-----B-M--Xo--B--E-----B-M?-?X-o??M-EB-oE-Bo-X-XEB-EBMEM-XEo-M-EX--E?M--XM?o-MM?--oMoXoE--Bo--EME-E--XE??E--?-XoB---X-B--?-B
?---oEXB-----oB-----X--o-XMBo-oX-oM---B-B---BB-XoE--o------E-EB-o?o-T--oE-----X-M-o----E?B--------B-M------o-E---o----?-EM--?---B-MoXE----EMoE-----M--E?--?-MXB-E-M-B--M--o--B--B-----M-E-M-?--?-o--EE-|
M-?-oE-----MM---o-EB-B--------oEX---------MBE-oBMo-------T----M---E-X-o-B-XoX--?-o-o-X---E-BX------XM-o-?B-B---X---o?BE--------MMoE-E-?-X-?-B---X-X--------B-?--E-M-o-X-XX-E?----oM--X--B--?--Xo--E-----
o--B---M?XE--M-X-o---E-XMoE-----M?o---T-M?BM---M------X-M|-BME-----X---E-M------Mo---E--X-E-------Xo?--?--B----MMo-BBo-M---B--oEBB---X-X-oEX--X-M--?-?-X-?----TMEoB-E---------XMB---??-M-?-B-oo---MX-XXE
TX-oEX-M-o-E--o-EM-X-B?---T?--?-?---M-|--?--X-?----B-MM--|--o-E?XEo-------M-----M---E-o?-M--T--E----M--B-----B----?--EoM-?---BEM--o???E-o-----?-M----B--------XM----?----o----Eo---B--?-B---?E----M-----
B-----?-EBE--X---o-B----X?|---?X-?-Mo?XMEo---M------ME---|-B--B-o?-----X-X--X-E-----BM----M-|-----E-E--B--MX----o--B-M?--E-?------?-E-?X-E-B------oo-M-----o-o-EM----?o--?--E-M-?-M--o?oE-----o?E---Xo-v
?--B--E-B-----o---?E?M-?--X-?----M?EBoB---EBB-Xo----M?o-oX--?---B-?o------?---oE-E-X--------X-o--E?---B-----X-Xo-M-------oX-B--X--?--BT--?---X---X-MX-?---MEM-X-B-?B-?E?------EoE------T-?--E-Bo-----oXM
oo---T-----o?--X?--o------M---E-BE----o-?-o----------oEo?-?-ooM---T----o??oE--M-X--M-M-o-----EE--T--B-E?---?--B---E-X?XX-?-----o--?-E-XM--o-BEXE-??BMEM-B--?--------B-Eo-B----M--E---M-|-M-BM--o?-E-M?-|
T--B?|-------Mo-?-----?-?-----B-oBEoXoM-?---BoB-MM---oE--M--o-?---X-X-?ME-M--B--EXB----EE--X-----X----------E------------T-X-M---M--oB-B-X-X--E---------o-?----B--E----------Xo-----T--|BB--XX-?--?--T-|
T----Xo-MBME---?---------o--?---B-?---o-------B-------?-X-B--X-o??XX----B---E-o---E--M-B-Mo--EoB?oB-XB-X-----E-X--?M-----XE-o----E-EM----M-EM----E--B?-?-------E----XXoM-M---?-Mo---|B-|-----BXE--M-E|B|
XX--X--EM?B---T-M-M---M----X-oE--X----E---------E-o------E-o------E-B?o-----M------o--o-o---E?M--E---oX-?----?M----M--B-?-----E-X--E-B--B-M-o----o-?------?-E-o---oB---M--M--M------X--XoMMoB--------X-B
B--o--E-oB--M-|-----------?--M---M--------E-XB---X-X--E-X-----E---------oM?-o-X-------?--B--E-M--M-o?M---EoBM--------?--?---oE-B---------Bo-M--E--------M?--MoBX-M---?-----M?--M-o--------M------?----Bo
m-XB--???----oX-X-M----B---BoBEME?MM---BB-EEBo--EBM--MBM-?XMBMB-BMMB------BM-?oBEo--Bo--E----oM-----Eo-?----oXBXoM?X-o--o-B-??-?oE-E-XXoXEB-Mo-B-B-E-BXE-?oE-?o---EB-B--?oM?o?Mo?B-BXoBMoXE----XME--X--?
XXXXXXXXXXXXXXXXXXXXXXXXXXXXXXXXXXXXXXXXXXXXXXXXXXXXXXXXXXXXXXXXXXXXXXXXXXXXXXXXXXXXXXXXXXXXXXXXXXXXXXXXXXXXXXXXXXXXXXXXXXXXXXXXXXXXXXXXXXXXXXXXXXXXXXXXXXXXXXXXXXXXXXXXXXXXXXXXXXXXXXXXXXXXXXXXXXXXXXXX
