---------------------X-------------XE-----------------------------------X-------?----------------X----------------------E---------------------------o-X?---XX-------------------------------------------
-----------------------------------------------------------------------------BM---------------------------------------------------------------M-------------B------------------------------B------------
-----B------E--------------M-----------------------------------------------------------?-------------------E---X---B-------------------------------------------------?----B-----------------------------
-----------------X--o------------------B----o--------------------------------------------------------------------------------------------------------XX-------o-----------------------------------------
--?--------XM----------E---------------------------------------------------------------------------?--------------------------------M-------------------------X-------------------------------X-E---X---
---------?------------------X----o--------------------------------------B---------------------------------B-----------------E----------------------X-------------X--------------------------------------
--------------------------------------------------------X-----------X-----------------------------------------------B--?B------X-------------------X------------------E-----------------------------E---
--------------------------X-------?--------------------X----------------Xo------------------------------------E--------------E----------M---------------------------------------?------------------X---v
---?------------------------B----------------------------X-------------------------?------------------------E-------------E-------------------------o---------------------------------M------Xo--------f
-------------------------------------------o-------------E------------------X---------------?-------------M---------------?----------------------------------X-------------------------X---------------f
----------------------E----------?--------E----------------------B----------?----X----------M-------?-----------------------------------------------------------------M-E--o----------------------X----f
----Xo-------------------?-------T--------------------------------------------------------------?-------------------T---------o-------------?---TM----T------------------------------------------------f
---------------------------------|-----E--------------------------M?-----------------------o-------------o----------|-----X-----?---------------|-----|-------------------------------------T----------f
-B-------------------T-----------|-----------E-M--------------T------------------------T----------------------------|---------------------------|-B---|-----------------------------------T-|----------f
m------------T-------|---T-------|----------------------------|---T---------------T----|----------------------------|------T------------T-------|-----|---------T-------------------------|-|--------T--
XXXXXXXXXXXXXXXXXXXXXXXXXXXXXXXXXXXXXXXXXXXXXXXXXXXXXXXXXXXXXXXXXXXXXXXXXXXXXXXXXXXXXXXXXXXXXXXXXXXXXXXXXXXXXXXXXXXXXXXXXXXXXXXXXXXXXXXXXXXXXXXXXXXXXXXXXXXXXXXXXXXXXXXXXXXXXXXXXXXXXXXXXXXXXXXXXXXXXXXX
