-----------------X--------M------------------------X----M-------------------------------X---E---------------X----------------------------B-----?o---------------------------------------o------------X--
----------------E-----------------------------------------------------------------------------------------------------------------------------------------------------------------------------E--X------
---M---------------------------o---?X---------------------------B-------?----------------------------------------------------------M--------------------------------------------------------------------
----------------------------------B------------o------?-o-----------------------------------------------------------------------------------------------E------------------------------------------E----
-----BE-----------B---------------------------------------X-------------------------M------------------------------------------X---------M------------------------o-------------------------------------
---------------M---------------o------------------------------------------------------------------------------------------------M--------------?----------------------?----------------------------X----
---------------?-----------------------X---------------------------------------------------------------------------------B--------------------------------------------------------------------B---------
-------------------------?-----------------------------------B-------------------------E-------------B--------------------------M---------------?----------------------------------------------o-------v
-----B--------------XX------------------------------------------------------------------------M--------------------------------------------------------------------------------------------------------f
----------------XX-----------------------------------------------------X-------------------------------------------------------?----------------------------------XX---M----------------o-----------o--f
----------------------X------------------------------------?--------------------------------------------B----------------?--------------o-----o-----E-------------o--o------------------E--------------f
------B------?--------?--------B-----------------------------------------------------------------B-----------------------------------------------------------------E---------------o-------------------f
-o----------------------------------------------------------------------------------B-------------T-----------------M-----------------------------------?-------------------------------o----------X---f
------------------------E?-----------------------------------------------------------------X------|---------------------------------------------X----------------------T---E-----------------T---------f
m--XXX---X----------------o-------------------E------------M-X--XX-----?-----XoXMX--X-X-----X-----X--------o---------X-------------------B-----X---X-----------X-X-----X-----X---X---o-------X-------X-f
XXXXXXXXXXXXXXXXXXXXXXXXXXXXXXXXXXXXXXXXXXXXXXXXXXXXXXXXXXXXXXXXXXXXXXXXXXXXXXXXXXXXXXXXXXXXXXXXXXXXXXXXXXXXXXXXXXXXXXXXXXXXXXXXXXXXXXXXXXXXXXXXXXXXXXXXXXXXXXXXXXXXXXXXXXXXXXXXXXXXXXXXXXXXXXXXXXXXXXXX
