X----EXo?-o--XM-XB-o??oXBB----?--EEo-oEXM-E?--MEXE-E-X---E---?-o--E-EEX-E?EX--E-XE--M-EXE----EM-X-X-XX---X-BM-?--EX-EoMXXB-X--M-BXB-M?-B-Xo--M-M-?X---MoME-X-o------EB---o??E--oM-MBM-X--E?-B?EEB-X????B
XB-------X-BBME?---M----E-o-E--X-EM--M---?-E-Xo-?--M--------?--E--E---B--XE--?-----?M?--B----?--?Eo?B--E--M--o-X-E-M---B--Eo-X--MBo-XB---o?XMB-o?-oEXMB--E-E?-BM--B--E--E----?M-BE?X-Mo-B-X-B-E--M?MME-B
?-MX---------B-M-XB----M--MX----T-o-o-B----E-----X---M--?B-MM--M--?B-M-o---E--B--X----?X-XM-o-o--T---?------XXoo--X-----MXMEB----?BB-Mo----T----E-o-o------?-M-------X----?M?B-M-------EBME-X----M-oX-M-
T---?o--BM--TM----T----M-----o--|-To-E--?--?-B?-----MTT?-EX--?-------------------T---E-------Xo--|----?------------B---B------X-o-B-Xo-T---|-X-----T--B--ooX-E-X-X-XXE--B------?--B-oo-o--o---E---ME--B-
o-----E-M--EXM---EXo--M-E-E---?o|-|-E-B-BE?-T-E-o-?--XXMBB----o-o----?---BE-----?X---BT-----B--E-|----o-B----B----BE---M--E--M--?X-M--?|---X-E---MEX----?----o-BX-----XE---X---B-B----?-?---------BE-M--
?-X----------E---E-B?---MM----E-|-|--?----E-X?------?-M--EB--X--E-E--------E---------EX----------|-B??---o------------?-----------B---?|-X--T-M-T--------o--oB-o-E-o--?---E-?--?-MEEoo--?-o---B---EM-M-T
--B----o---B--------o--------M?-X-|--o-------T--B---?---M--T----M------o--------o-?-M---------T--XM---?-?-----X-E----X-?-E?EX-M--E----T|----|X-EX---o-----TT--BBB---TE-----E---EB--B-------------?-B----
|X-B--o--E----B-?o-X?T?------B--?EX-?----o---Xo---T------?TX------B-?--B------E------?--------|---MMB--TB---B-------BE--E-----B?------XXToE-|------BE---E-X|-Eo-----X----M-??-------E--o-?---M--BBM-?--v
?---X-E---------?o--BX-?---?o?-EB-?-----T?----?---|--?XoXB|B-----TM--T-M--M----------T--------XT---o---|M------------MBoB--??----?------|-EE|XMMM---B-B---E|-B---?o--B---M-o------E---------T--ET?o-B-??
-------------------M---?-M-?o----o--o-oM|M-B----TM|---?E--|M----M|ET-|M---Bo----E----X-----?o--Xo--M-EB|----MB-T-----B-T--?----M----o---|---X--?--o-----E-?|------------------------BM-o--B-XE-BX-E---?T
|-E-------------o---?M---o--?-XBT-------X?--EXTBXEX-----BMX--M-M-X-|-X---o-E--------o-----o--------B---X?-M----X--o----|-?---M---B----?-XB?----------o-E-?-X?E--E----E-BT------EX-X-?--E-----BXMM?M--?-T
-M?--T-?----T-------------------XE--------M---|----T---------T-----XT---X---T------------TT-o-----T----o-------------E-|--X--E----Eo----o---------TT----------B--T------X----B--------T----Eo-------oTTX
B-?-T|-M---?|------------?-------------T------X----|----?-B--|------|-------|---------?--||-------|E---------T---------X---------?-o----T---------||-------E-----|T--T-T-T----------o-|--------------||X
?TT-||-T----|---T----T-T---T-----------|T--T-T-----|----TT---|T-T---|--T----|T----------T||--T----|T---------|-------------T-T-T-T------|---------||----T--T---TT||-T|-|-|--------TT--|-------------T||E
m||T||T|----|-TT|----|-|T-T|-TTT----T--||--|T|TTTT-|T--T||-TT||T|---|T-|-T--||-T-T------|||-T|TT--||TT----TTT|T-TT---TTT-TT|-|-|T|--TT-T|T---TTT--||T---|T-|-T-||||-||-|-|-----TT-||T-|-T---TT-T-T-T|||B
XXXXXXXXXXXXXXXXXXXXXXXXXXXXXXXXXXXXXXXXXXXXXXXXXXXXXXXXXXXXXXXXXXXXXXXXXXXXXXXXXXXXXXXXXXXXXXXXXXXXXXXXXXXXXXXXXXXXXXXXXXXXXXXXXXXXXXXXXXXXXXXXXXXXXXXXXXXXXXXXXXXXXXXXXXXXXXXXXXXXXXXXXXXXXXXXXXXXXXXX
