--------------------------------------------E------E-----E--------------------B--E------X---M-------------------------BX----------------------------------------------B------------------o--------X--X--
------------X-X----XX-------------------------------------------------------------------X----------------------------------------------------------------o-----------------------------B-----B----X-----
-----------M-X-----------------------E----o----------B--------------------E----M------------------------------------------------------------------------------------------------------E-B---------------
-------------------------------------------------------------------------------------------B------E-------------------o------B--------------------------------------------------------------?-----------
----------M---------------------X---------M-------------?o--------------------------X-----------------------------------------------------M--------------------?o---------------------------------------
------------------------?-----------------------B------------------------------------------------------o------------o-------------------------------------------------------------X---------------------
-----X---------------------X-------o------------MX----------B------E---------------E----B--o----E---------------------------------------E-?-----------------X-----------?-------------------------------
----o-----XB------M---------E-------------------------o------------------?-------------------------------------------------------------X------------X-----------------?---B---------------------------Xv
-------------o-----------B--------------------o------------X-------------------E-----------M------------E----X-X?------------M--?---------------------B-----o------M-----o-----------------------------f
---------------------------------------------o------------------------------?Xo-------------X-X-------------------o---------B---------X-------------------------M----------------------------?---------f
-----------------------------------E---------B------------------X-----------------------------E---------------------------o--------------------------E------------------------------------E-------EEXX-f
---------------------------TT---------oT---B---------------------X-T----------------------?-----------T-X-----M-------------B----------------------------------X?-?----------------E-X-----------------f
---------------------------||---------X|---------o--------------B--|--------------------?-------------|--------------------------------------------------------------B------o----------B-T-------------f
---------------------------||----------|-------BX---------T--------|--------------------------------B-|---------------------------------?---------E-T---------------------o--------------|-T----T-T----f
m--------------T-----------||----------|------------------|--------|----------------------------------|----------------T--T------------------------T|------------------------------------|-|----|-|--T-f
XXXXXXXXXXXXXXXXXXXXXXXXXXXXXXXXXXXXXXXXXXXXXXXXXXXXXXXXXXXXXXXXXXXXXXXXXXXXXXXXXXXXXXXXXXXXXXXXXXXXXXXXXXXXXXXXXXXXXXXXXXXXXXXXXXXXXXXXXXXXXXXXXXXXXXXXXXXXXXXXXXXXXXXXXXXXXXXXXXXXXXXXXXXXXXXXXXXXXXXX
