EoE?E----B?-BoE?--B---XoB-?-?EXE?EB-------Eo-?B--E-EX-XB--XE?-oE---oB?--E??-oBX-o---o--X--o?BB--oB--?EMo-X--?-o-?M-oo?E?--?-----Bo--M---EM--M?MEoo--o-----B?----X?-MM-?M-----?M-E---B-M-Bo?Bo-BXX?X-?BXE
?E-BMoB---?E----MB--M--MoX-?MB---E---??M?M---MM--B-B--o---E--BoX?EE-B--X-E-BoE--?-----Mo---MoX-X---X---BEEB-XB-EEEo--EBEX--oMM-E-o-?o---BBEX-E----o-BE----o-MM--BMEBE-?M---X?-MMo?BM-EB--BEEM--MMTE-o?o|
-oB-Xoo-E-o-E--E-X-E?--?-E-o-MB-oB-?--?E-EB---oo-o---M------?--?--E---?-MEEo--M-??X--o-?-oo-M-o--?-BX-o?-oB-Bo---?X-MM---M-XB-X--?---oBE---EE--BEBXEX?--M?EX-E?----------E-ME--o-?-MM--E---M-EX-M|Bo---B
MM-E--------?-X------------B--M---?---oMBX-oX?--MB------ME?----B-M--E---?-oo-EB-E--o----M--Xo-BE----X-X-o----XE-XBB------MM---E--T-X----Eo---o?oE--?----o-B---E---M-EX--E-M-------------E--X---X-|E----B
oE--?MB-X----M-----------o-E--o?---E-----M----BM----X-X------MMB------oX---M--?--?-ET---E--B---E--?---M---------o----B---oM-??--?|---B-M-E---M--M-------BE---------X-M--------?--------X---o---E-|Bo--X-
M?B--B-----?---E---Bo-B?-----o--------?----------T-XMo---------M------M-X------?----X-M-?----B-o-XB----ME---?-----EM--B-o-?X-o-?-X----E--B--B-Xo-----XB--B?---M-X------B------?----------E-----?-X?--BBX
o?-----X?E--------------?E-EX-------X-B---o--X---|-E-----E---------B-M---T--E---EEX------?X?-??---E-o----XEBE-E--E----M------?--?E--o-------B--o---M--?------?---E-------T---?o---M?-BMo---?-BBo---B--?X
MEo--o?------?--MX-----M--B-Bo--M-?--E--o---ME---X-BEX----B?M-----B------|M--?-?--------M---oBMBM--Bo-X--T---X-?M-BE-MooT-EB--?X--EB------o------XoEE------MM------E----BX---------------BE-?M----X--X-v
o----------B--B-E----EE--E---M----o-------BX--B-E------B-XB----B--o---XE-XB-M--?-E?o-E------E--o--B--M--B|-----ME-------|M-E--E-E-?-MMEB?E--o--o-E---??--MT------B-------B---------E-----?B?-?Eo-------?
EE-M---?EEX---------TM-------M-o--oX-E---o---M-B-X-MM-M?----B---XB-?---M----E---X--o---B--BM--B------o-EE|?-o----XEB----X-EMB-o----M----E--o-E-?---BX--?MT|o-o------oo--------B----o--M----M-EE-BB---X-|
X-X-X---?M-o-------BX-B---BM---------BT-B--E------X-oE----M---X---o?--M---?o-Mo---------E-oBE-----o??-E-?|EBM-BM-M-B?oM-------E---E---E--M---M?B---o?o-M-|X---MEMX-------E--B-?X-E-o-XoEB-----?-B-BM?--T
T--T--E--o--o---MEBTM------?T---B---XBXM--X---o------?BMX-----o---T----T--E-?B?--------X-o---TT---------oX?-o-?--MT----M--?-----X---?--B-T---------------XM-ET--B-o-------X--o-----B----T-Xo------T-??XT
B-T|--M------T-----|------??|-------------?-o---T--T-E--M-o-M--B--|----|-M--?--------M-------|X--B-Bo-----EoM-----|---TB-----B---B---X-M-|TX?-M--------TB----|---E----o---o-M----TM?--T-|---------|----M
?-||------B--|-----|-T----T-|-------?-XX-B---T--|--|--TB----T-----|-M--|--X-B-E---B-------o--|-------------------o|---|--T-X-ETX-M-T---E-||-----oE----M|-----|-X-T-------------T-|--T-|-|T--T--E--|---TE
m-||---------|--T--|-|---T|-|-------T---T----|--|T-|--|-----|----T|--T-|---------------T----T|---TT---T---T-------|---|--|----|----|-T---||------------|-----|---|-----T--T----|-|--|-|-||-T|--T--|---||
XXXXXXXXXXXXXXXXXXXXXXXXXXXXXXXXXXXXXXXXXXXXXXXXXXXXXXXXXXXXXXXXXXXXXXXXXXXXXXXXXXXXXXXXXXXXXXXXXXXXXXXXXXXXXXXXXXXXXXXXXXXXXXXXXXXXXXXXXXXXXXXXXXXXXXXXXXXXXXXXXXXXXXXXXXXXXXXXXXXXXXXXXXXXXXXXXXXXXXXX
