|XooE?E-BE?BM-oB--X--ooBBMo?-?X-B?EM??EoEo-BMoB-XEEB-BXEX-XM-B--EXX-BMoE-B--?-BM?-o?B---BBBo-?o?--MBo--Xo---?-MX-o-BEM-oMBoEM-XoB-?E-X-?B?-oo-M---B-MXM-EEM--MM-o---EE-B-----Xo--?o--Eo--E-?-E--??--E-oX
Tooo-EX-oMEE?EoMXEXMX-B-?EME-oMoM-oMXB-X?o-?-X-M--X?oE?XBBBEB-M-o-M??-B--oB----MEoB---EX-X---?B---o-X--oE??E-B-X?-MB--?---XM-XM-oM-M-oBo-B-?BM--XE-?--o--B-?o-EM--?-X-??-EBXXEM-----M--o--M-----XBX-MM-T
?B?E?-M-oXM?o-oXB-o---M---X?-BM-----oXEX-?--o--BEE?-X--B--B-?-M--??--o-?M--BoEE---X?M-?Bo?---BB-oXM?E?o-------E-BMoXMX-?MEB---o-MM-M--?B--oEEXo?EB--X-B--B-?B-oX?-?MoE?--M?MBXB--??BoE?BM--?-?----MB-o?M
|--------oXM----?B-----M?-----X--?-----?---o----MX-o?-?E----M?-B-oMB-o---X--B------M-E-B?-E--B-----?o----o?--?o-EX-o--------?-B--o----BX-oXE-oX?oM-----XEM-----B----o--B-BT-o-?---?-oBB---?T--?-------MT
-oM-?-B--?o--E--o--X?-?o--BX---MM-o-o----X------M--M?--E--o-BB--EB--B---EE-------MB-EM-EB-----------o--B--ME?E---?--o---M?o-E--M----E-----E-o---oEB--------------XET------|----EX--X-------|Xo---?X-X--|
Mo-M-E------MMB-E-o-----?-?M-M------------E---X--B-E--E-------M?----B--B-M-E?-----?X?---E--MX?-EBB-E-?oB?-------MB-?--o-BM-B----?-?-------------BEo-MM---M-X----M--|------X---X---EBX?---?-XM---M-E--M-B
TE--BT---X-M----B-oo----?-o--E-----------o-o-o-EB--M-B---MB-B----XM---o--B--MX-MB-Bo----M---o---oo-B-E---B----E--M-------EXMEE---?B--E-o--?--B--M--B--------M--E---X?--Mo--?---o---?-----M-M-B-----E--BX
T-B-?X-BB---E-E--M-----o-X-?--?X-X-------o-------E--M??----------------EM?X---XEMM-------M---X----o--M--M---ooM-E---MX--Xo---oE--o-----o---o---X?-o-E--E---?-MBB------M-Eo?o-oX----M-M-o-E---?-E-------v
X--?E---------EMX------EB?-??--o-oMo-----?E--?X-----?-----B-?---oE--BXB-o--M----E---X-------o--o?--TB-E----?---------?B--MoX-?B-?M---o--MXEM-o--o-E---E--?M-?-E-EE?----XB------M-M----?o----o-B----X---o
E--oM-----M--o-B-E-X-Mo--oE--o-----o--??-EMB----?--o------o------------M----EM-M--M-M-Mo?X--?-?----|--o---E?B-B----E--E--?B-EE------?-M-------o--M-?M-?X-M--B----E-E?oX---EM-M-B---B?-----M--MBE--ooX?-M
M-M?-----??XB--EMB-?--o--E----B------o----M--T----X----E----M-E----o-X-------Bo-?BoBBE---oB-?--B?M-X-----M----E-----M??--o---M-M--E--B--B------E-B-o-EE-E---B?-------BE-o-B-oE-o-?---?XB--o---MM--?-B-?o
o-MBo---T------o?--T-o----X-----?---M?ME---BEXX-oX-------------M-------?B-----BM-B-------B-o--------B----EEB---?-------E-----T--E-?--??---M------?--E-------B------XE--------E--E--?----o-------TT-B-X-|
|-M-----|---XMME---|-----M---B-M-----MEo??---MM--o---MXM---o------B----o--X?B----E?---------------?-------------X----?------BX---E?---------M--------E----BBoM--?E-oB--T-B--?-E-?---?B------B---||-M-oo-
M----M--|T--E---ME-|-------?-----M--M---o----oB-------E-------?-oXB-M-------Mo------------M-o--XMB---MB----M----o---o-----------?---------M--?---T---TBoTM-o-B----Eo-B-|-Bo----oEo-T---------B--||?--?M-
m--T----||---------|------T------------------------T--------------------T-------------------------TT----------------------T--------T-------------|---|-T|----------T---|-----------|--T-----T---||-----B
XXXXXXXXXXXXXXXXXXXXXXXXXXXXXXXXXXXXXXXXXXXXXXXXXXXXXXXXXXXXXXXXXXXXXXXXXXXXXXXXXXXXXXXXXXXXXXXXXXXXXXXXXXXXXXXXXXXXXXXXXXXXXXXXXXXXXXXXXXXXXXXXXXXXXXXXXXXXXXXXXXXXXXXXXXXXXXXXXXXXXXXXXXXXXXXXXXXXXXXX
