-------o-----o------------------------------o-----------------------------------------X---------------------------o-------------o-----B---------------------o-----B-------------------------------------
-----------------------------------------------------------------------------M---M-------------------------------------------------------------------------X----------------------------E---------------
-----------------o--------------o----------------------B------------------------o------------------------------?-----------------------------B----------------------------------------------------------
-------------X------------X-----------o-----------------------X-------E--B------------------o---------------o----------------X----------------------------------------------o?------------------M-M-----
-------------?-------------------------------------------?-----E--------XB---------------------------------------------X-------------------------------E-------------------------------------------X----
--------------------?-------------------------------------------------------M-----------------------------------E--B----B--------B--?----------?--B------------------M--------------------?-------------
---------E------------X---------------------E----------------B-----E--------------------------o----------------------------------------------X-----------------------X-----B------M----------M----------
----------------?-----------------------------X---------------------X---------------------------------------------XX-----------------------------------------------------------------------------------v
---------------------------------------------------------------------M--B--E------------------------------------------------B----X-------------------------------------------------------------------X-f
------?---------------E----?-------------X-----------------------------------------------------------X--------------------------------------------oE-----------------------------X------------E--------f
---------E------------------------X---------------o---X------------------------o-------------B---------------------------------E---------------o----?---------B------------E---------------------------f
-------T-----------------------XX--------------T---------------T---T--------M----o--------------------------------------------------B---------o----------------o--?---------X---E------B--------T------f
-------|---------------------------------------|---------------|---|----M--o----------------------?-------B--------------o---------------T-M----------------------------------------------------|------f
-------|-----------------------M---T-----------|---------------|---|----------------------------------T-----------------------T-X--------|-----?-----o------------------------------------------|------f
m------|------------------T------T-|-----------|---------------|T--|----------T-----TT----------------|-----------T--------T--|----------|--------------------T-----------------------T---------|-----TX
XXXXXXXXXXXXXXXXXXXXXXXXXXXXXXXXXXXXXXXXXXXXXXXXXXXXXXXXXXXXXXXXXXXXXXXXXXXXXXXXXXXXXXXXXXXXXXXXXXXXXXXXXXXXXXXXXXXXXXXXXXXXXXXXXXXXXXXXXXXXXXXXXXXXXXXXXXXXXXXXXXXXXXXXXXXXXXXXXXXXXXXXXXXXXXXXXXXXXXXX
