-BoooBX--EMM--XE--BB----oB-M-MEB---o-M?-MEBM--o-B--EBE-EM-----oE-o---E?BoM?o?EM--X--M?-?--?oMoo--E--?-E--TEE-X---MXM?B---oM?E?MXM-?XEEo?B-MMBM-E-??-E??-Bo--MB-ME---?-X--X?---MMM-oMM--E--E-?B-B-E-BXoBM
T--o----?-oo----B?----?-E--Bo-E-XMBXB-E-o?o-X?-E-?---o-?B-XM--o-MBX?-?-oM?ME-E-E---Eo--BX-M-oM?EX--X?EEM-|-BM--?X---XE-----?M---E-----?-BXM--MB-?BMBB-Mo-?-?X----EE??-Xo?Eo-Mo?---?Eo-MM?o--M--E-MX-?E?X
oX--X-E---oXo-?oX-?--?E-TE-M--E-?M?--oB-XE---BoM-oMX--XB?B?B--B?ooM---?--?M-B-----oEM-?E---?--Bo---?MM--M|E---B----M----BXB-X-EBXo-B---?X-o--BMBM?Eo-M-----o???BBE-?o--M---B-B?-o----B--XE-o-E-?--ooM-EB
o---E--BM?-?-E-----XX--o|-TB-M--o---?T--X----?MXo----?--EB-----XM-oXM--E-Eo-----X-?-E-------------B-X?-X-|------ME--?---------XE---BB-X-o---X----B--B-M-E--XB----------?-------------B-----??-?X--?---Mo
|-o-o---------o--X--E--B|E|------E---|---Bo-E-o-E-?-----B-E-?-EMo-------M----o--BBE-Bo-E---X-X-?---------X--B--oB--M-?X?--?-------?--Mo?E-o-M--?B--o-Bo--E--Bo-E---oM?------M-XE-----E-?--X----------?BT
?M??-----M--?o--o--B---EX-|----?B--X-X-E-----EE--M---o-o-----?-E-----?----?-----M-E-B---?--?---?B--oM----------M------E-E-TX----B-------M?---o-?-E?E----B--B-------o-oBMB--E-?---BoM-----M-B-X-MBM--o--B
B?-oEo-MT-------E-X-X-B-o-X-----?-M---?-----------E---X---BE-----------oX-EM----E?--Eo-EM----Bo-------M---E?--X-XT?-B-o--------?---BToo?--X-o-?M------Bo---------M--EBE-------o-o----M-?----M-----X-?-BB
|--M-Mo-|-------ME----?MooTXE--?-X---?M--E-MXoE-B-?-o----E------o-----B--X---M---------M-BEo-----o-?EX?-M-B-----o|--M-----X--E---?M-|-B?--MX---E-------MXo-ET-M---MX--------E---?-?-BE---M--?-----BEM-Bv
BBX-o--E|-B-M--o-----X---M|B-EXTE-?--E--X-B-------M--X-XT--?---E-M-E----M--E--E-?-MX---BEo?-EXB----?MB-----E?--o-XB----B--o-Bo-----?|-B---E---?-X-M------E--TX-B----XM----B------M--B------?M-?---BE--BE
M--XB---X------M-XX-------X---E|-B----??-X-BXoo----ME---XXE--B-?--M-oX---X----o-?-o---B---?-----B-E--M--XEM-?----E-M---o--M---???--BX-E-----E--o----o-B--B--|-E-----E-?------ET----?M??---B---TE-------X
?-------E-o--?---E-M--o---EE--E|----B-EE-----BM----o--B-B-o-o---?X-EE-----oM--?----------M----------X----B-E-o----o---B-T---Bo?---X---T--oo-----------o-----XMM?M---o--X-B--?EXE-??--B-?--BM?-X-----EE-E
E---T-----T---o-?--------------X------o-BT--o--?EoE---E----B-TBX----T---E-oM-?-----B---------X---M---X-X---------BBTEM--|---oT?-------T--?-?------o--E---M-M-B-T--TE---T?-M-E?B---?oT-----E--MT-o--T--MM
B---|-----|--------X---------X----E----T-|-------T---BB----E-|--E?--|T------T------M-------o-------------------o--M|E--BXT--o|------X-|-E-?TB-----------E------|--|----|?--E-----EM-|T--------|----|---M
|---|----E|--------M------X--E--T-MT---|-|-T-----|-------oT--X------||-B----|----T--TT---T-T---------------?----T--|--T--|---|--------|?---X-----------T-------|--|----|--------T-T-||TB----T-|----|---|
m---|-----|-------------T-------|--|---|-|-|T-T--|--------|---------||----T-|-T--|-T||TT-|-|------T-----T------T|--|--|--|---|--------|------T---------|---T---|--|----|--T-----|-|-|||-----|-|-T--|--TM
XXXXXXXXXXXXXXXXXXXXXXXXXXXXXXXXXXXXXXXXXXXXXXXXXXXXXXXXXXXXXXXXXXXXXXXXXXXXXXXXXXXXXXXXXXXXXXXXXXXXXXXXXXXXXXXXXXXXXXXXXXXXXXXXXXXXXXXXXXXXXXXXXXXXXXXXXXXXXXXXXXXXXXXXXXXXXXXXXXXXXXXXXXXXXXXXXXXXXXXX
