-B------------------------------M-----M------------------------------X-M-------------------------------------------------------------------------------B---------?---XX-M----E----------------X---E-X---
-----------------------------------------------------------?M--------------?-----o-----E---------?------------------------------------?-B------------M-------B--------X----------M-----------------?----
-----------------o-----------------------E---------------------o-------------M------------X----------------------------------------------------------------M-------------------------------------E---X--
----------------------------------------------?-------o--------------------------------------------E----------------------------------B------------o-------------------------------------------------X--
---------------------------------------------------------?----B-----------M----------------------------------------------------------------------------------------------X------------------------------
------M----------------------------------------------------o----------------E-----------------------------M-------------------------------------------------------------------M-------------------------
-----X----------------------------------------X-----------------------------------?--------------------------------M-----------------------------------------------------------------M----------M-------
-----XX---------------------X-------------B----------------------------?------------------X------------------------------------------?----------------------------------------------------------------Xv
------M---------o-------------------------------------------------------------------------------------------B-------------------------E---------------------------------E------------------------------f
----?----------------------------------X-M------------------------------------B-----------------------------------------------------------------------------------E-------------E----------?-----------f
------------------------------------------------------E----------------------------------------------------------------------oXoo------------------------------------------------o---------------------f
-----E------EX-------M------------------------------------B---------------------B-------------------------------B---------------------M--E--------------------B----------------------------------------f
--------------------------------B---------------------------------------------------------------------------o-----------X-----------------B-------E--------------------M-------------------------------f
-?X---M-B-------------------------------B---------?-------------------B-------------B-------------------------------Xo---o-----------------------------------------------------------------------------f
m-B------?---X------------B-----X----X-oE-----X------------------------------XM-----E------X--------X----------X-XX--------------X----------------------X-------------B-------------X-----------X------f
XXXXXXXXXXXXXXXXXXXXXXXXXXXXXXXXXXXXXXXXXXXXXXXXXXXXXXXXXXXXXXXXXXXXXXXXXXXXXXXXXXXXXXXXXXXXXXXXXXXXXXXXXXXXXXXXXXXXXXXXXXXXXXXXXXXXXXXXXXXXXXXXXXXXXXXXXXXXXXXXXXXXXXXXXXXXXXXXXXXXXXXXXXXXXXXXXXXXXXXX
