|-oX?E-?o-ME-MX-M-E-BE-BB-EBXBX--M?E--B-?EEoXB---?-o-B--M-EB---------oX-X-o-E------X-MEX--?M-?ooXBE-MM-M-M--M--E-MXoMoXX???o-XM--M-XoMMM-o?E?EXoMX-o?o-???--o-E--EBB-XooEBoBE---?-??---oEMo-Eo------E?E|
ToooX------X-M?-X-----MXX---E?----o-X?-M??-?MXMoB-BM--o---X--o---o?o-B---X---Eo-o--oE?--B?-Xoo--BBX---XB--E--oBBE---o---EB?-E-oE?-E-?-B-M-XBBMEM-B-M?-MXoMXXo---o-oXoXXB?oBE--M?BMX-XX-o--MEEEMB-X---?MX
E-?--oBo-XB---MXo?--B-oEE--M-------?o--?--X-?--o?-?-E--?MB-M-?oEM-M----o-B?--XX?----X-Xoo-Eo-X----M-XM?-?-X--?XMMB--B---B-E-M-o-X---E?-E-ooo-BX--XEB--?E--oB--oo--BB?BB-X?E---EX-M--Bo---BXEEEM-XB?-EBBE
E--M?------?-T-M-B----o---X---BBE--B-----?o-X---------X---E?--X----B?-B---MMo------M---?X---XE-----oB-----XB-oXE--o---oM--E---------------oo-MB--M-B---?--X-Bo-T----B--?B---E----MoEB----------B-E---?-|
o--------MB--XXo-EM-B------------XM-?----?--M-oX-BEoX---M----?-o?M-B-X----EM----M?oEo------o------E-----------E??BE--M--XM-oE-?-?-?X-?-B--E----B---M---M??-----|----MX-Eo-Bo---B-ME-----------B---XX-?-B
oB--BM-----oo--B--EM-------M--?--B--?------X--?--M?----o----o-B-E-?--?--ME-B------B--oB---B---M-o-E-o----?--M-o--oM?-M--E--?-----X?EX--oX-M-----?X---XM-?BX----|-XEX?B-?-----B---ooX-?X-ooXM-Xo-X--M---T
E-----TXX------B-----------?---o-----?E?--o--oE-?M----??X-X---?B--o--?-MMM?-XB--B?----BBBE-M-X--M---E---M--M-X----M-----M-E--?---oo--X-B--------B-B------------Xo--o----E----o--E----E-M---?X---?---M-XB
B---T-Xoo-?-----BM-----XMM--E------E--BEX-E----EEM?-MX---Boo-----XM--?-------E-M--M-XMoM-----o-M-X-X--o-E---M----X?-X--BMM-M-X----BE-?--o?--B-BMo?-B---?M------Eo-B-oBE---E-E-M--oE--M----o?----M-----ov
X---|B---o--Xo---?-?-----E-Mo-o------?E---MX---o---E----------oMoEM------X?---M-Mo-B-E?-M-?o--Eo--M-E-B?---?---X-?o-MEo----EM---MX-o--o----X----M---------MoB-o------M-BM-??EB-----B-?---o--XEMB-XX-?--B
---?|-B----BBT------B----------?---o-?---EBM--EM--Bo--o?---X?----?---?-----M??o-----X--?----B?----?EE?E-ME-BoE-oX--?-M------B?o-B----E-----M-M--?o---B----Mo-----o--M---E-------M-------M-X?--EoX--EM--X
o?ooX?--Xo?--X-oM------M-E-?--o------oEX--E-ooM------E------?-B?--?-oMXX-T-B-M---B--EEXE--o----M-EB-------?--BM----M--?-M---ME--E-B-?-B------o-X----XE---B---MM------B-o--o?-----Eo--X---?o-B?BoE--?---?
MEB?--?----M-----BB------M-B-o-----E----Bo-----??M---E?--E------BB---EE-?X-oBo-M----T?-B-M----------X----M---M----oo-o-B--o--?oB-T--------?---------?--o-M-X----XXX--Bo?Mo----X---B?--EM-T-?--EM-Xo---EE
Mo-M-B------?-E---M---E-o------o--EE-BB-?oB----E-o---?--?E---?-o-o-o-----ooME---X--?|M?-?--B?-----??----------?E-o-o-M---------M-|---?X-----?----?-B--M---X-B-----M-o------?--oM---o-o---|?E--ooE-Mo--M?
B----T--------EEE-------M-?----o-M-MBE-B---M-----------------------M------B?B--B---M|---?-?BME-------M--X----------ET-----MM----?|---E---o?---------??MM--E--?-E---E---------E------?--MB|-E----B-----Mo
m----|---T------------------------T-------T----T------------------------------------|-------------------------------|-----T------|----------T--------------------------------------------|--------------
XXXXXXXXXXXXXXXXXXXXXXXXXXXXXXXXXXXXXXXXXXXXXXXXXXXXXXXXXXXXXXXXXXXXXXXXXXXXXXXXXXXXXXXXXXXXXXXXXXXXXXXXXXXXXXXXXXXXXXXXXXXXXXXXXXXXXXXXXXXXXXXXXXXXXXXXXXXXXXXXXXXXXXXXXXXXXXXXXXXXXXXXXXXXXXXXXXXXXXXX
