---o-BMo-?E---B-E-oMX?o--?Xo--oX-M?M?--??-B?-?Bo--Xo-o-X---EX?-?MMB-B-X?----o-EoBXB--BE---E--M-BB--E--B----??X-MM?oX-E-BB--?-Bo?B----XE?M-MEB-XoEX?-XB?B-MX-X--MMo--E-oX--X?-XMXo??-B-Xoo--E-B--ME?-XEE-
----M----BEXXEo-oB--E?-BX-----o-MXME--M-MEEoo-B?X----EM-oMXoEM-?-o-M--XEo--Xo---XM-E-ooo-?----MXo----MMoXE-o-M?--X-B-EM--M?MoEM-X?M?BE--XB--o-E----B-BEM-TX----Bo?M-o-oBX--EE-MB??-M-X?o?X?XoMBB-BXX?-?-
-ME--M?M-X-?----X-XE--?E??-?BBMM-BM?-oEo-E--B-oMBXo--XB--BBXB-X-?-M--o-o?B--X-M-Mo-B-MoE?-M-MME---BXo--E-??M-o?---B---B?-Mo----BMM--BEBBX-M--E?-?EB-ME-X-|-X-o-----ME---B??--?---E-----E-BEoX-X--B-MEo--
-----o---?B--E---?--XB-E-o--o-?-B-----EBMo-?Eo-M---B--XB-----X??--------------B----E-o------XB-T-----------M-Eo----?--X-Bo--Xo---Mo?-E--X---E----------o?|---M-oBB---------?------X--E?-o--Bo---?-----E-
---T----E---B--T---X-----B--T----------B--Xo--oM-----B?-T-X--B--o-E-o-ME--?TM--BTT-E-E----o--oB|oX-----E---BX--B?-M--------------B-o------E------EB--E---|B-B-?E-E-------EB-----------?E-------o?--o-MT-
---X----E--o-M-X--E--B----M-|Eo--BE-MB-T-?M??---EE--Mo?X|-M-?--XB-B------o-XM---XXX--------X---|-o-?--?M----E-BM--o----------B---TB--E-?-M---?----?EEB--XX--BB-o---------M--X--?----T-T-Eo-o----E--B-M|-
-B--ETB----B?------?-?--o-?-|?M?-o-----XX--E--M--?------XB------E------E-----B----TX---B---M-M-|M--?o-----M?BB---------M-X-oE--o-X---o-M-B-----------EB--TM-M----X--BXo---E?-------BX-X--oM------?-E--|-
-----XoB--X-B?----Xo-B-BE--?|---T--ME----M---------B---------o-M-ME-----BE----oM--X---M---X---MX---EBME-o----E--Xoo-----X------M?E-----BEB-----X------B?M|--------BM--M-----E-E?-----Mo??M--?M---E---XXv
-----B----T-----E?-E-??M---oX-M-X----------B?--B-M----X?X-?----EBB?B----Bo-TX-E-----o?-----B--M-B----E-M--B-------B?X-BX-M-oo-------X?-oE-BXMX-TM-E-E--?-X--MEXM-?EM--B-------E--M---M----M---B-E-o--M-f
--E-X-EX--|-E----M----oo-----MEX-E-X-E--B-X--TEB--XE-----------o-----M---o-|------B--?------E-M----?-----B-----------BT-B-o----?M?-XoTMM-oo--B-|o--X-Bo-B---oM----o-----Xo------?E------B----M----o-E-Bf
--o--E--M-X-BX----BB?M?B-B??----Eo?-B----BB?-XB--M---oMo----ME----X-?oB----X------?--?--?---E?---?o---oE----MX-MBM--X-|--B--?X-------X---?oE---X--M-B--o--?-MMM-B-?EM?-----E???--oB---XE-B----o-?----Tof
-----------E-ME------B-M-EEo--E--E-M---T----------EEE----o-o-TXMB-------T--?M--------E-E-MBT-T?-o-------B-M-B-M--B---TX---------?-T--o-TT------?-------------T-----o-B------o---oB--T---X-MB--M--T--oX-f
-T-BT--BB----M--o------E------------E--|-B--T---o-----EE---T-|-E-------M|-------T-oE-------|o|oE---------------------|?---------M-|-B--||--------MX----------|----o----o--E------M--|-?--Bo-M-?--|----Tf
-|--|Mo---T----------------------------|B--T|------T----?--X-|----?-----|-----T-|M--T--?TM-|-|-----------------TT----|T---T--B-T--|X--E||-E-----E------------|T---B--T------T---E---|B-----T--B--|?M--|f
m|--|---T-|T-T-----T-------T-----T----T|T--||-TT---|--T------|--T----T--|-----|-|---|---|-T|-|------------T----||----||---|----|T-|----||--TT----------------||-T----|------|-------|------|-TT--|----|X
XXXXXXXXXXXXXXXXXXXXXXXXXXXXXXXXXXXXXXXXXXXXXXXXXXXXXXXXXXXXXXXXXXXXXXXXXXXXXXXXXXXXXXXXXXXXXXXXXXXXXXXXXXXXXXXXXXXXXXXXXXXXXXXXXXXXXXXXXXXXXXXXXXXXXXXXXXXXXXXXXXXXXXXXXXXXXXXXXXXXXXXXXXXXXXXXXXXXXXXX
