XX-oBE--?-o-BEoBoEX-E-EEE--o?-?oEMXX?-----X----X--E-Xo---EX-E--XEBE?B?B--ooX-X--E----o-o-o--M-o?EXB-M-B--o----BB---BE--MXMoX-----o-?-X-?B-M-XM-E--oBE--MooB??-o--E-E-M-oMB-BXX-B-?-E?-oX--X-?-EME-XM-BB?
o----Mo----ME-o-M-?XoX?o--X?---XEMM--ooM-B---?-X--B?--?-E--EBo-Mo--oE-o----?-o--B---BEE?--MM--MoE---?EM--T--MoX----BMMEoo-X-----?-----B-XX----o-B-o-M--EEMo-XX--X-E----oB-T-oBoM-o--o--M?--?oM-BX-M---XX
-oB-B--X-o----BE--E-XEXBME--TE-M?o-EMBM---X?------X-?-?---T--E---oTMMB--X-?---B---oX--EMTM-E---TX-T-----X|X-BX------E--?-XM-oMBE--E--E-E?B--?-XE?B-X----M?-M--o-XX----B-T-|---MoBBT---X----?X-?--?M-MXoT
X-o----B-EXo---T----o-oX--X-|-------M-X-E--?-?-BX-?XoM---?|-----X-|---o--XX----B----B---|---B-M|--|--BBX-|-?-B--E--E---X-E-?B---MX?T-BB--oX-X--E----?-E---X?-ooEX-oM-X-E|M|E--X--E|B-BX--TXM---X--o----?
BM?TMEo---o-?X-|oo-E------M-|------TM--o----?-o---E?-M----Xo-BE-?-X-oB---M--E-B----o----X-MB--EX-MX---B?-X---?-----EM?M----o-o-?-XX|T---E-?-M--BE--MX-Bo-M---?o?-?-B--o-X-|--X----|----BB|-oM-EB-E-----E
X?-|--EM---EEo?X--o----MooE-|BE----|M-B?--o----o-E--XEE-MTM---o-B-?BB----o-?--E-oX?-M--o-E-B------??----E---ME----??-B----T----B---X|E-o-------M-M----E?-E-----?M---o--E--X----XMM|-----MXTB-M----E-E-BX
X--|----------EoEB?M-BBE---?X-B?-EXX-------Eo----?----E--|------M-?-B---------E--MM-BMX------------?X-M---E----o--E-o----M|BEo---Eo-|Mo-B---oB--M-oMoXX--X-----B-o--B----oM----M--X-E---MX|oE----o-X-E-B
o--XMEB--?-ME-?-MEo-M-M-E-To----X---Bo-o-o--??oX?----oM--X---?---o-M-----o--------M----?---?-o---BMo----o-----oo??B-B-----T-?-----X-|-E------o-B---------------E-X------B--?----?o--X-----T-E----B-M--ov
----o--E-----o-B---o-----E|---E-----T---EE-M-E---o-?-----E--------M?-----?B-------o-B--MB--E----oE-EXB----T-----oB---M-XXX|-X-------X---------BM----E--?--------?EB?-EX-----E-X--o------B-|--E??--?E-M-?
o-?-M---Xo--?---Bo---X---E|--E----E-|---BBo-----?---E-?---?-?-B-E---?--------EXE?M-o----M-----BX--EMoX--Mo|M---E-M-M-EMBo-X?E-M-BE---Bo-----M--ME--EM---B-?o---?M---------?-----E--o--EE--|-?E-E-E----Mo
B-?-?E--B-------E--o-X?E-?X--B--??--|MB--------M-B---E-E-E-E-B-MX-B-E?-o-------XM--BXB--XM---?X-B---B-----XM---XB-----oM-----?-EoM-X-M-XXooX----?X--MXX---M----EBo--X-B-oE--B-?---?o--?--XX--B--E-E--o-B
|-T?-E-?B----BM-E-T---X--T?-X-----X-T----------------------M-M-----EE-----B-------T---T-?---E--------?X-------X-E-T----o--M---T---o---M--------T-----E--B------M----T--M-X--MT-------X-TB---------E----M
X-|----X-----T----|------|---T------|-------------T--T--------M----M---BB--T-----o|---|T-------TT------o---------E|-?----E-T--|---------------E|-o-T-T-----T-X------|------B-|---T----T|--X------------X
o-|----------|--TT|o----T|---|------|-T-T---------|--|--------T-E--------T-|---TT-|---||T------||---T-T-----------|--TT----|-T|-----------T---T|---|T|-----|-T------|------T-|---|----||------T--------X
m-|----------|--|||-----||-E-|------|-|-|---------|--|--------|----------|-|---||-|---|||------||---|-|-----------|--||----|-||-----------|---||---|||-----|-|------|------|-|---|----||------|--------M
XXXXXXXXXXXXXXXXXXXXXXXXXXXXXXXXXXXXXXXXXXXXXXXXXXXXXXXXXXXXXXXXXXXXXXXXXXXXXXXXXXXXXXXXXXXXXXXXXXXXXXXXXXXXXXXXXXXXXXXXXXXXXXXXXXXXXXXXXXXXXXXXXXXXXXXXXXXXXXXXXXXXXXXXXXXXXXXXXXXXXXXXXXXXXXXXXXXXXXXX
