-----------o-----B----------------------B-----------------------M-----o---------------------------E------X---------E------------------------------------------------------------------------------------
----------------------------M-----------------o------------------X---M--------------------------------?-----M-----------B----X-----?-------------------?--B-----------------------------E--------X--E---
----------------------------B----------------?-------------------M-------------o-------------------------------------------?-----------o-------------E------------------------------EX-----M------------
-----------------------------------------------------?-----------------------------------------------------------------------E-------------------------XX-------------------B---------------------------
------------B--------------------------------------------------?--------------------X---?---------------------------------------M----?----------------B-E--------------------o-----------------------o--
---------------------------------------------------------------------------------------?---------X---------------------------------E-------------------------------o------------------------------------
-----------------------------o----------------------------------B----------------B----------------------------------------------------------------------E-----------------------------------------------
----------------------EM--------------------------M-------------------------------------------X--X------------------------------?-------------------o--------------------------------------------------v
-o----------B---------------------------M--------------------------------------B--------------?---o-----------------M------o--------------------------------------------------o------------------------f
----------o-------------?-----------------------------X----------------B---------------------X------------B-----------?---------?-------------------M----------------------------B---------------------f
------------------?---------------------M-------------?B---?--------------------------M------------T---------------------------------M-----------------------------------------------------------------f
-----------------------------------------B-----------------------------------------------------B---|---------------------------------------------------------------------------------------------------f
----------?B-----------------------------------?----------------X-----------B-------?---------B----|---------------------------B------------------------------------------------------------------XX---f
---------------------------------------------------------------------------------------------------|--------------------------------------M----------------------T-----------------T-------------------f
m-------X---X---X------------X-----------------X?-------------X---------------E--X----------X-----XX---X-X------B-------------X---------X-----X-XX-----X----X-XXBX---------------X-X--X----------------f
XXXXXXXXXXXXXXXXXXXXXXXXXXXXXXXXXXXXXXXXXXXXXXXXXXXXXXXXXXXXXXXXXXXXXXXXXXXXXXXXXXXXXXXXXXXXXXXXXXXXXXXXXXXXXXXXXXXXXXXXXXXXXXXXXXXXXXXXXXXXXXXXXXXXXXXXXXXXXXXXXXXXXXXXXXXXXXXXXXXXXXXXXXXXXXXXXXXXXXXX
