-BEEXo?EB-?-?EEB?X--M?-XXoo---E-EoE-B--B?-XoB-M-X-E-?E---E-Bo---M-E--MX-BXB-o-----EX-------o?--M-XEX-----XXB----B----o--MB-X--o-B-E?BE-XX?BEoMM--EE-M?-??BB-E-----o--E-M-X-o----??---M?B-X-?oB-o?X-M----
--X?o-BE?--?B---M--E--?-M?E-E-EM-E--MEo--BME--?--o---EB-E-oE-Mo-?o?-EM--o-BoX--?-E-?B-Eo---EM----EBBM?-?-o?--MM?Eo--E-E-EEEo-MEM?E?-?X-EX?oMEEMXMXEEM-BEB-EM?B---?B-M--XE-o-EoMEEM-o--M-MEEX-o-E-M-E----
--M-E-------?o-E?E--M--oM--MX--?BMB--XX-B--XXoo---?--X-BE-o-?-X--X-?--------M-B--M-?--oo?Bo--?-M-B-MEB--B-?oooEE-M-M??---X-XEo--X---E----?----X-BX--B--X-?-B---------X---X-M-o-o-----MM-MB-?BoBE-BX?-?--
------?E------EM--?---------ME--E--------?---E---XB-?X--XoXoE--?-----MXB?--XoB--o--?--------?--EM-o--B-?---M?---------------oM-----E?MoMM--E-EE---?MoB?-M----X----B---------XM-?-----EM?----o----?------
-E--X-----B-M---?E--BEX----BM---?B-M---o-E----B----XBB-----??----?T--?ET--MB?-M-M---X--?MoX---B?EB-EM-----?ooME-M-----MB--B?M----X----------BBEo-B?-?M-o------X--?--?o------MoX-E----------o-M----MM----
-o-Xo---M----?BE-------oB--E-M?-B?---T--EEM----??-?--M-?-X?o------|-M--XE--E----B-M---E--o--E---o?---X-Mo-o---MB--MB--BB---?--o--B-?-MX-----E---------B-o-Bo-M--------X-Mo?E-?o-?BE-B-oX--M-M---o--?-B--
---ME?B-?-BX-------o--T--o-----oBE-B-|---M--E--M?---M--B---BE--o--|-----M--------EM--EM-EE---B?M-Mo--o--?--o-B-M----EB-BX?----MBo--?---BB-MM----Eo?----?oX----o---B----B--E-X---B-B----o---E---E--------
------?M-X--?--o---?--X---E-?---M-o??|X-o--XE-M-?---?B-M---oM---X-X----XB--B---?-EB?o--EMM-E---B---M-M?o?o----o--Bo-B-BM-E-XX-M--o-E----B-EoE-o-o-M--oM-----B--M--M?--X------o-------o-B--B-?o--X--E-oMv
--o-BE--?--B--E---M----E----E-oBM----|oXo-X-M--X--B-----B------X-??---oB--M-B---?E---M---BX---B--oBM----M-E----o--?MoM--X---M-M-E---oM-----E-o-M----?---Eo------oB----?-EME-M------o---?--E----o-T?----f
----M--B-------Eo-?-XM---E--o-M---M-oXM--M-X?---oE-o-E-M--XE-M------------E-----?-----------XXBBM---M---E?-E--X?--o-Eo----X-o-B-M--o--X-----Eo-------BE?-----M-------E--?-E?M----oM-------------X|E----f
-----EB----Eo-MBM----?-?-?o---BT---o--------------?--?--------X---o?M-M-------MBo--M----------B--EM--?BM---E-----MEE?o---X-M-o-oM-B--XM---M--?-----?-E-------BE----oo-M--?------?-E--?X--B--EME?-X--To-f
-B----oX---E-?-----X?--MX-M----X---?-?o-----o---B-?-o---M-----?-MB-o-?-?E----E-E--------oM-X--B----E-----B---MT-M--M----E--Bo--BEoBo--M--XM-X-M-EE-oXo-X--------o-----B-X-o----o-MoXM----?----o-X-oM|--f
--?-E-----??---------------o?--M-?-MoMB--B?-?---?M-----oo--B--E---E--o--?B-M-----XX--X??-MB-MB--E--BBX?--MoM--XB---o-ME-E-?--o--o-MB---oTM?--?----X--?B-?X----o-?X-?E-M?--o-Moo---?----M-Mo?--?E?---|--f
-o-B-----E-?M---o------B------XBM-o-E----?-?BM-E-B---M-------XBo-M---o-XE-?----------o------B----------E-B-------------B---oM---E---B---|oB---oX---oE--o---M--B-M--o-Eo-----B-B---MXXM-----?--------XB-f
m?E?-XEoB-EBEoM-BXM-oMX--EX--?M--XME?M---o---oBEMMB--oXooBX-XB-oM-EMBB-o---XEo-ooMM?MBoBME??M?X-M-B---o---?---M-Mo-ME?oEXEBoMo-X-X-E-X?oX?---X-?M--M-Xoo---BEM-----MoBoB-X--o------?EE----B----B-M?B?--f
XXXXXXXXXXXXXXXXXXXXXXXXXXXXXXXXXXXXXXXXXXXXXXXXXXXXXXXXXXXXXXXXXXXXXXXXXXXXXXXXXXXXXXXXXXXXXXXXXXXXXXXXXXXXXXXXXXXXXXXXXXXXXXXXXXXXXXXXXXXXXXXXXXXXXXXXXXXXXXXXXXXXXXXXXXXXXXXXXXXXXXXXXXXXXXXXXXXXXXXX
