B---BEoM?---BoBB----BoB-o-M--MoBEMXoMo--X-BEo-BB---??BEEXE---EoME-X-X?-X-M--?-oo---MEE---EoXEo?M-o-----?-EMX-M?-BEM--M--MXBMo--B----B-E-M-BXB--B--EoB-EBMEXEoME-EB--o--XE?XEE--MXBE--E?----EEXEMEM--B-M|
B--B-X-?oE-MMEMBoBoBXB-B-Mo?Boo--M-----o?X--MM-X-?BoMoE--EMX-?XBMXE---BXBB?B-EBXXEBX--MM?---o?M-E-oX?EBXX----?EX?-B-?--EBE?o-ooMXX?-X-B?BE------M--B-B-----?---?o---?-MXXM--MoBX--X-?XE--??-B-EB----oM-B
B--?-B--MoEo-B---BE-oEBXB--BMoMB---BEB?-?BBoM--oX--MB-XE-X?--E--XXM--EEoMEMo--?oo?XB-?E-E-X-oo--X--M-oEE?E-MoB-?EMEX-oE-MXB--XE-E-M-M--o---MM?X---B--oEB-----Mo-M-B??-----E--E-oo-B-E-Mo-o--X?-B-E--XXB|
B-E---EM-Bo--X---X-BBB?-MT----?--B-?MMM----E-EoX?-E---o---E---?---M---oX-BE-----X-M---oMX----EMXE?E-?EE--?-X--M-EB--------M-E---?--MX--XM-o--BTTX--------o--o?--EEX-B---------o-?--M----------E?-----ME-
o--?-------B-E-X-----o---X-----M--X--B---o-----?E-B-oBo--X-B--??-o-X-?-M----M-?M--E----o-o-?o-------BM-XB----------E?--MX-----?o--E-E--E---E--X|BXX----B--B----B?Eo---?-E-M-----M--?--X-----XB-BX?----BE
M-------o-E--MM-oBT-o--E---M-E-EE---------B-EBM--X-----M---B------M-?B---EX-------B-oBB---X---E--?-?--X-?-B-Xo-EEXM--------------X---XEET-o---EXo---??----B----?-o--------?o-o------E--M-----o-?M-?--?E?
-B-oE-------------|oE--?---?--E-------o?---BM?---o-----B-------BXX?X--B-M----M----MB------?-EMEBo-o---M------M----------MM----M-----EB--|----?o-T-B---oX-------M-----oE-XX------XE---MB-X--EXMM-M-B----B
XE--B---XBo-XoB--EX--------------EBXEo------EMB-----E----M----E-o-----B---oBB??---------o-----M------E?o--T-T---------M?--o-X--BM----o?-XB--oB-B|X--o-?B-XE-----X--?-B-M---X----?-Xo?M--------?----MEB-v
T--E---o---TMo---o?---X----E------o-M-----o----o-o-XB---B-o-B-------------B--EM---M------X-MBB?E--XB---M-X|--o-X------MEE-o--------MoB?-??---BXMX--?----M-EM-X---XMEBT---E-M-------B--XM--------oXE----M
T---XE---?-|-?-----M-X--M-----BB-----------X-oMB----E-X----M-XBo--?BBE--?-M?-B--o--M---EX-B?-?---------Eo-X-X---X---MM----BB--M-?E---?-----M-B-----M-?--E-BBo-o-----B|oX-------oT-X---?------o---Bo--o--
B---M-o---MXE--XX-XE---E-X-----E--E--X-oXE---B--MM-TB--o-------EME--B--B-----E--?X-?--X--?---?-?--M-MX----o?-M--?-EXo--XB-----M--B--E---M---M-M-XB----E-o----M-M-E-o-|-oB-MXo-BEX-B-X-M---------?-M-oE-M
T---?--X------E?-oM--BEMooBo?---X---X-M---X-XMB---XXM-----E---o-----?-B-----o--M----o---oM-B------?-EB-BXX?------------??--?-X---B-----------o-------E?X-E?-o-E-XE?--X---B-----M?--B------B---B--X-MM--E
M----MX-------T------------E--XM-----X?E-----o----B-----M--?-T------oX-----B----M-M-MM------X-----oM-----M---BoX----E-----o---XEM--?--M-oE-B---E--?-X--------E--o-ET--?-T--------M--M--E--T?-B-MoMoEE-T?
o-M--T---o-E--|-EEBXEM--M---M-----TX-B------MMEX?-----?---B-o|--Mo-E---B-------?-----M-----M---?---TX-------------MMEXX--------?o?-oXE------Xo----?E--o-Mo-M-T-BE--|X---|----M---M-----B-MT------EM--E|M
m-T--|--------|-----T-------------|-----T-------------T------|T------------------------------------|--T-----T--T--------------T------------------------------|-----|----|T----------------|-----------|B
XXXXXXXXXXXXXXXXXXXXXXXXXXXXXXXXXXXXXXXXXXXXXXXXXXXXXXXXXXXXXXXXXXXXXXXXXXXXXXXXXXXXXXXXXXXXXXXXXXXXXXXXXXXXXXXXXXXXXXXXXXXXXXXXXXXXXXXXXXXXXXXXXXXXXXXXXXXXXXXXXXXXXXXXXXXXXXXXXXXXXXXXXXXXXXXXXXXXXXXX
