XB-BX-o---EX----B-?--XM-oXBEBBM-B?-?--T-?--o?o-BB-M-BB?--XBMM-X--EE--M-?-EB?o------MX-oME-EB?X--ooM?--oB-EEXXEB-?M-B-oB?oo--BMXM?M--X-EoBE--B--Boo-M--o--B?-?EMooXM?----EM?BXB??MoBB---?-BM----XMo-X-M-?
?--o---M-M-MM?-BXM----B--MM---M-?E-?EX|??XX-??---E-----Mo--MX--XEE-oX-oMB-E?-o--M-----?E--Xo-----??M---?--oo----?o--EXo--BX--o?o----MX--Mo-M--BBoo-?BX--E----TB-X-XEoo--M---X-M-EMMXMB?E-?X--M--o----MBB
?-----??-E?---E--?MXo-X-oo--B-----E?o-|--M-oX---M-o------M---M?-M------EM-o?-?o-E-Eo?MX--oXB--X------------B--o-T--M-EB-E---EBB-M-E-?-M--M---o-----M-B-X--?--|----EE?o-Moo-----XoM-M---o--oXM---oB-XE--?
---ETM-M-M?Xo--------B--B---X-----?o--|M-Xo--M-o---------oM----o--MX---TB---M-?-XE--------E---E----?-o------B---|---BoMX----E-o--?E-oE-----?-X-TMX---oXX-----|-X--EE--?--o---X--oB-?--oE----MBE----E--oB
T---|-X-----?-oBBE--X-BM---o-E-----E--X-?--MB---?---E-?----E---E-------|-?-E-------B---MBB--E-?---o-----?----B--|--M--B?-M------MXo-MM--?-X----|BoX--E---E-E-XE----M---------oE----?-M-o--T-?E-EE-?X---E
-T--|B--o-----B--M--M----oM-B--?M-?-----o----BM-E--E---------Eo--?X---XX---ooE-Eo--XX----M---oo--o--T--o-------TX--?o---B-E-E----------EoX-XE?XX?---X---X-----B?--------Mo-X-M----B----?--|?--o---o-oX-?
E|-M|----oo-----B--MB--X-?--??E--E------?M-?-------XE---EB--?--XXEE--------?--BM?-----M---M-?M?o---B|----M-?--?|------E---?---?----oMX--Mo---EB--E-BME-M-o-o--o-oE--BX-----X-----o--------X----ME---Bo-X
T|B-XEXo--M----X--E-E-B--o-E------B---M----E---X-?-X----E-------------?Eo------X?-??--?---B---o--?-EXXo-T--?-Mo|o?----M-o---?-B-M--E-o---T-M--M-oo----X-EBX-?----oB-B?M?----XX-?----E--o--BE-EXM-oEE-E-v
MX--E-B---?B--X----E-?---oXB-X-oo----T-o----M-----?--o---B-----?X-?---?-T-BMX---E---Xo---T---------E-?--|------|-----o--------M----------|o-?-----X--??ME--oB--?M---E------T?-oB-----o---X---?------?--B
?MM---o--Mo---?E--EB-o?o--?E-----X---|---oo---B--oo-----X-XBEXo---------|---?-B-Mo--?-M--|Boo------oo---X----?-XEoXM-E----E--E--Xo---M-?-X--XB--B--E---o-B-?MM-E------M----|-?--?---MEE---X----XBB-X--XM
o--?----E-M-o?----MME--B-EB-----X?---X--M-X----E-o??----EM-?-----BEM-XM-Xo--E----E--B---X|oXM?--X-B-B?--o-?M?---B--B----?-E-E----M-----Xo--XX?-M-X--B-B-EB---o-M--EEXEB-B--X-----E?M-M-o?B----E-----M-MB
X-X-BB------T-?---M-BE--T-B------------E---E-E-----B---?----TM-----T-TT-----E-X--T--E----T--------------------TM-----------------oE----M-----E----XM--E------------?--o----------?---T-----X-M---T---?-B
E---M-TXT-M-|-X-----M---|--o-T-T----T--T--ET-------T-----T--|----T-|-||-E---T---X|X------|--------B----?---T--|-------E--------E-----T-T------------------T------------T----o--------|---T-M-----|---T-o
------|-|--T|T-B--------|-TT-|-|---T|-T|T--|-----T-|T--T-|TE|----|-|-||----T|T---|---T---|-TT--T----------T|--|--T--T-------TTT--T--E|T|-T-------T----TTT-|--?-----T--T|-----T-----T-|---|-----oT|---|--
m-----|-|--|||----------|-||-|-|---||-|||--|-----|-||--|-||-|----|-|-||----|||---|---|-M-|-||--|----------||--|--|--|-------|||--|---|||-|-------|----|||-|--------|--||-----|--M--|-|--?|------||---|-|
XXXXXXXXXXXXXXXXXXXXXXXXXXXXXXXXXXXXXXXXXXXXXXXXXXXXXXXXXXXXXXXXXXXXXXXXXXXXXXXXXXXXXXXXXXXXXXXXXXXXXXXXXXXXXXXXXXXXXXXXXXXXXXXXXXXXXXXXXXXXXXXXXXXXXXXXXXXXXXXXXXXXXXXXXXXXXXXXXXXXXXXXXXXXXXXXXXXXXXXX
