--BXM--?X-Xo-?---??EM--BB--oo-?X----MMX--EB----oE---?M--X-o-M-E?-BE--MBo?--BMMo--B-EMEE-X---E-BoE?---ooEXM?--EE--M--BBo-oo-?X-?-E--MME-EE-X----M?-??oME??oX-B-?MBXo---oEB-BB---X-E-XB-E------MX--X-?----
--MMB--BE-E-EM-MMoo---?---?-?-EM?o-EE-EooEE-?oEBE--??--Bo--EEMXEo-B----EXM-X---XXXX?-o--BMM-?-E--X--M-?XXMX--o-MX--X-B?oX-XMo-o-X-E-??ooM?o?-oME?oBM-EoMMMEXE-??-XXEo---Eo-?--o-o--E-B?BB-----XX-EXME?X-
-E--Xo?-XBo?-Boo?M--BXX-?-MM--EB-?ooM--?-----XB--M---XEMMXoXB-oBB--X?XMoBX--B?-B-?MoE---o---?Eo--XB-M-MM--?-E--E--Mo-BoBMoXMM-EooE-oX-M--M-X--o-M--ooE--Xo--E----XE-X-X-B-Bo?--o-?E-EMoMo-BM?E-M-E--EEE-
-o?-?----Xo-BXB-EX-?-XoEo-o-E-XoM-o--X---oMMM-?o-oE--o---B-oM?-E-X-XM?----B---M---EX--M-B?--BoBXBB-EB-----X--B-XB--MBB-MoE-o-?--o---E----EB--o-oE--B-MoM-E--M----B?M?--?-Xooo-BE---M?E----E-M-oE---XM-B-
----ME?-X-Mo--?-MBX--Mo?BEEB-B?BEooo-oMM-EXXX?o-E-o-?BBXXo-XoE-o-?BEo?X---MBB-oM-----E--?-?oBX-?-?-MBoBX-MXo?--MMXo-BBB-Bo-o--X-B?-XMXo--MX?-X?-o?E-?ME-B-o-XBMX-?--o---XB----?XE?---E---Eo-oX---?EEo-o-
--M--BXM-MB----EMM-Xo?oo-?-BMMEE-E---EBXMMo-oo-BEEMMo--BX-XE-o-?BM-X??MBoM-M---BBB-MB--?--B-MBooEX??--?-o--oMEME--MMMX-EBX?-Xo--o-XoEB-BE-oo?o--XM-XX-?-??--BEXEE-XBXoE-B?-X-MMoE--XXBBo?X--E-XM-oBX-X?-
--B-XE-ME-MBMoE---XBX-M--oXEBX----E--oEo-E-?--B-o-EE-BB-X-??E-EM--XBoBM??XMXB-XBo-MM--?-MoEX?---EEE-?--E??o-B?--EMEM-Moooo-?MXB-E-E?oXE-M-oXME--EoEM-oM-MM-E?BM-M-E-B---X--M?oB--?MX-M--M-?-ooMXXooXo---
--MX-EXEoE?XE-B--BX--------M-o--E--?-MEBEEMo--X-o-EX-XBBEMoEX-MM--?-M-o?oXM-?-M-ME?-M----E--MB--?X--B-XX--MM?-X-o??-EXE?B?--oBo-MB-M--MM---X--?-M-?E-BX-?oB-?EME-E?MEXMMEM-MX-MBXBEB-oMM---Boo--?-?-oMXv
--?X?MM--ooX?BXM-MEBXM-o?E-EX--o-o-MM-MM---E-X--M-o---EE-B-EXXo--BX-----MX--oX-?X--B?-oXo--EEEEXBB-X--X--X?-----B-?BBBE-B?-?B-oo--ME?-Mo-ME-B-o?o?-?-?-MB-EE?X---X--oBMEX-XEE?B?MB-E-X-oB?-B??E?XM-o??Xf
-E?---M-M?--o--MoXX-MBoE-BEM-o--M-?o---?B-MM?oB-E--oXoXEXMMX--oE--?--X---BEB?BoB--MMo-??-?M--BXo----B-M?M--B-?-M--M--MoMB---?-Mo-XE-o---M-MooBB-M-MX--BM--o?--?oM?-E--MoMEMXMB-MB--o-B--E-o--MEE-M-oX--f
--?E-Eo---X--E---MEB-EoX-Bo-?-B--?--o-XEX?--ME?Mo-EMMoEE-BB--o---E---M-----MEEE---X-?---oB?o?-E--MoMMBB--B------o?X-BXB-oM----o-?XoE-o?-----?---XBE-MX-X-M-oE-M--B-X-M-E-E-B-o----MoB?B-oX?o?-X-o-B--o-f
--BM-oBEXE-B?X-XXM-XXM?oX-?--Eo-MM?oM--?MM-EEEE-XoXoo-?-BMXo--o??-XX--M-?-?-XMX-X--?-o-MB---XBEBE?BEE--X-XE-?-oE-EM-M--M--M-?--o---oE?BX?-XX--MMo--EBoBEM-?oBE-MEM-MXB-M---oE--EE--B-B-MXB---M-X--B-EEMf
--o?--?-M---XM-?-M-----E-B?---X?EE?MX-X?X-B?B?MX?EBMX-Eo?-oEMXXMB-?Mo-?M-M--?-o-MM-XXMoo-XB---M?XE-B-MMMM--oEE-?o-?-B-----EM-ME---B-XB--BMMEM--oMXo-M?E-E??X-BB--E-X?XMEXM-X-B?E-?XEoEMXBM---MXB-B?B--?f
--?oo-oXM?-?-o--EX-B-X?M--EXo-------X-E-X-B--EoBEMMMEE-X?-?E?BM?MME---?-o??XE--M--B-X-E?oEX-X-BoXM--Mo-B-oEMoo-MoEoMEE-oB?XBoM-o-EB?oME---M-----?E-oXEo---XEo?EM?-?B?---E-?X----M?-B---M-M?M--?ooEo-EX-f
mE-M--EM-?EoE---o-EE----M--X?-B-BMMEEE--M-EXooE-M-XEB---B-MXM-oX---?E?M---?X?ooE??B?EX---?oE--o-MM--o--B-BB-M--B--M?-Eo-MoMoXoEo----EX-BX-oX-B--M-oMXE--Xo--EoBEMXooEEo-??X--XX-----?-X-----oBMMB-B-MB?X
XXXXXXXXXXXXXXXXXXXXXXXXXXXXXXXXXXXXXXXXXXXXXXXXXXXXXXXXXXXXXXXXXXXXXXXXXXXXXXXXXXXXXXXXXXXXXXXXXXXXXXXXXXXXXXXXXXXXXXXXXXXXXXXXXXXXXXXXXXXXXXXXXXXXXXXXXXXXXXXXXXXXXXXXXXXXXXXXXXXXXXXXXXXXXXXXXXXXXXXX
