--------------------------------E-----------------------------------X----------------------------------------------------------------------?------------------------------E-----------------------------
--------?--B-----?----ME----o----------------------------------X----------------B--------XX------------o-------------------?----------------X-----?----------o----M---------?----------------------M----
---EM-------E---------------------------------------------------------------------------------------------------------------------------------------------X---X-----------E---E--------------------X----
-----------------------------------------------------------------------------------------M---------------------------------------------------?-------------?---------------------------M----------------
-----------------------------------o--M------o----------------XX-----------------------------------------------------------------------E-----o-----------------------------------------------------X----
-------------------------------------------------X-------------------------?-------------------------M-------------------------------------------------------B----------------------------------X---o---
--------------?------------------M----------------------o---B------M------------------B------------------------------o--------B--------------------------------------?---------------------M------------
---------------------------------------------?--------------------o--------------------------------o----E-----------E?------------------------------------------------------------------------B--------v
----------------------------------------------B-----------------------------------------------M--------------E-?-----------------------------------?--------M------------------------?-----------------f
-------------------E-------------------------------------------------------------------------------------------------------------------------E---------------------X--------------------------------X--f
-------B--------XMB--X---------------------M-------B---------B-----------------------------------?-------------------------------------------B---------------------------------------------------------f
-----------------------------M--------------------------E--B------------------------------------------------B-----------------------------E------------------------------------------------------------f
--------------X------------------------------------------------?--------------------------------------------------------------------------------------B---------------o---------B----------------------f
----------------------------------------------T---------------------------?-----------------------M--------o-------------------------------------------------------------------------------------------f
m-X---------------------------E------o--------X----------B-----------M-------B-------------------X----------------------------XX------X------B---------X----X-----------------------?----------------E-f
XXXXXXXXXXXXXXXXXXXXXXXXXXXXXXXXXXXXXXXXXXXXXXXXXXXXXXXXXXXXXXXXXXXXXXXXXXXXXXXXXXXXXXXXXXXXXXXXXXXXXXXXXXXXXXXXXXXXXXXXXXXXXXXXXXXXXXXXXXXXXXXXXXXXXXXXXXXXXXXXXXXXXXXXXXXXXXXXXXXXXXXXXXXXXXXXXXXXXXXX
