----o------------EX-----------------M-----------------------B----------B------------------------------------------o--------------------------------------X-----------------------?-------?--------------
--------o---?-------------------------------?--------------------------------------------------------------------------------------------------------------X--X----------------------?---------------M--
----M-------------X-------------------M--------------------------?----------------o---------X---------------------M-----?----B------------------E--------B-----------------------------------------o-X--
------------------?-----------------------------------------------X--------------------------o---------------------------------------oX?------------------------M--------------------------M------------
----------------------o------------------------------------------o---------------------------------------------------B-----------------------------------------------------------------------------X----
--------------------------------------------------------------------------------------?---------------B-------------------------------B--------------------------?--B---------------o--M----------------
--M-------X----B------------------------------E-----------?-----------------------------------------------------------------------B--------M------------------------------------------------------------
---------------------------------------------------o-------B------------?----------------------M?------------------------------------------------------------oT--------o-----?-------?----B-----------Xv
----------------------B----?--------E--------------------------------M---E------------------?------------?-------------------o----------E---------------------|?------------------------------o--------f
---M-------------------------------?----------------------?---------------------?----------------X---------------------M--------------------------------------X-----------------------B----------------f
--------------X----------X-------------------o------M------------o------------------------------B------------------------------------?------?X-X---------------M?----------------o----o----------------f
--------------------------B------------------------------------------------B----------------------------------M-----------M-------------------B------------------------------------------BX------------f
--------oB----------oX---B----------------------------------------------------------------B---------------------------------------------------------------------------------------------------------o--f
-E--------------------------------------------------------------------------------?--------------------------------------------------------------------?------------------------M---------o------------f
m--------X---X---------E--------------------MB--------------------X------X-B--------------X---X----X----X---X-------------?----X-------------X--X-----------------X---X-X-X-------X--X--------X--------f
XXXXXXXXXXXXXXXXXXXXXXXXXXXXXXXXXXXXXXXXXXXXXXXXXXXXXXXXXXXXXXXXXXXXXXXXXXXXXXXXXXXXXXXXXXXXXXXXXXXXXXXXXXXXXXXXXXXXXXXXXXXXXXXXXXXXXXXXXXXXXXXXXXXXXXXXXXXXXXXXXXXXXXXXXXXXXXXXXXXXXXXXXXXXXXXXXXXXXXXX
