-M-??ME--E-E----?-o-?o----X--XoB-MB-B-----E---oEEMEB--??Bo----?B?BMXM-M-oooE---?-MB?-XoXB--o-M?-MBo--X-MMX-M--B-EE--BB?MBMoo--E--ooX??Xo-?-?BBEo-X---M--oM?-M-?ooM--E-M---M-oBXXE---XBMXEo-BE-B--??MEX-o
ToBEE--X---X?E-EE-M-M-E--M??oEo--M-Eo-o?EMEo--EB-oX-E-?E-oB-X-XEBo---?X-E??-o--M---Xo--?BE----EXEXBE--o---??oXME-M--XX--BBoE--M-?B-?oBXB--?XX--o?--X?-X---o--oB??XB--B--E?-X--oo?o-oMXM-B-EBMoX--BM?MM--
----?M---MXE-B-BoX-E--oX---BBE--M?BBXE----BXMXo----o??--E--Eo-X-X?---MB-BXBX---oo--?o--Eo-XM----o?--XE?-?--ME-o--oXX-M-MX---MXBMTX-ooE-M---o--B--Eo--?T---XX-XX--XE--?XEo-ME-----B-oE-XX-?---M--E---X-E|
B-M-Bo----oXM--o---BB---M--X-X----?--E-EX------B---o-E--B-B------B----E-oX?---MXMEoMM-oXo--E--?------oo-----XB---?--X-BE-E----X-|X-M?-E-M------Eo-E---|--T--B---X-----?BX--B--E-o---o--MX-------M---M---
-BTXo--?-o----E-o-E?----B----o-----BoT--?-----M?-BT---B----M-o---MX---o------XB-o---------B-----B-------ooB--?--B-------X-X---ME|---?--M----E---?----XX-o|----?M----X-E-?-M---M--XX?-----M----B------MM?
M-|---o-XB--M-MoEE-oo--B---E---BE---M|B-ME-B--oM--XooM-o---M-B----------XXXM-M--------BM-XM?-B--------MM--?Eo?E----Eo-----o---B-XB-----oE---E------XX-B-o|---E----o---?--M--------B--X--?T-oX---?----?-B
?-X---o-E------o-------Eo-o---Bo?-E?-X-o----------M-E----E---E--BX---o---Mo-----E-----Eoo-B-o------------Bo-M--XXEoM?---E--T-EEo----E--B--M---o--EX--o?M?XE--?-o?B--o-----?T-E--oEo--BEB-|o-B---M---B--T
?------o---E-E-BMM----X-?----B-----Bo-------M-?---M--E--?------E--E---X--o----E--------E-ME-oXB--?----Moo-B--?--------BB--o|M--B?----MXo-?-M---E----M----BB-B--?---M--M--M-|o-?-MME-o----|-X-----T-X-o?v
MoB---X----M?B-------ME------??-?-B-----X---------MB----B-X--o-E-BoX-XB--B-?EB-X?---oX-E--B----o?-o--X-----?-----BXBM----oBX-----E-??--E-M-E------MB-M--XMM-o-XT------E----X--o-E-----B-o|-o---o-X-B---|
T----E--M--o-E------o---X------X-----BBB-o-X-X?---oo-?B--M--M-?oXB---o-X--X--EE-o--T---MoX--X--BMM-MoE-Mo--------oMM?-MXT?o----XMBM-oB--X-E-MB?oEME-X--X-??----XEM---o---M--o----?E---?T-X---TB-XM-M-EXo
M-----oB-----M--o?E---X---o-BM-TB------?---o-?o--------?M?B-BE-----M--E-oMM----T---X-B---BB-oB--------E-B-?M----X--E-B--XMM?----MM?X-?-E--o--M--?----------?--M-------B-X--M--MM---E--M|---o-X--M---M--o
M-Mo-X--T--?-?E-B--BMT--------EX-TX-o-BT-o----o--M-E-B--To---M-M--EE-?----M--MX|M--T-o--o------T-TX?--o--E-T--M?-X-----o-------o----E-E-B---B?---B---E----o-??-----BBE-----M-T-o-------X-X-----TT-----XT
o-----ME|--------Bo--|BEB----E---|-----X---T----E-------|-------T-T------M-----X---|---M-o-----|-|--T---o--|-T--------?--oX-------Bo-??-----------o---o-?----?---E--E-----T-E|--BB--E------B---||--o-o-X
X----o--|---T---T--M-|---T-------|---------|--------T-o-|-----T-|-|-TXT---T-----T--|--XT-M-----|E|--|------|-|T-----oo------------?---T-------X--------------oT---MT----T-|T-|-T--T-B----------X|------M
m------T|---|---|T---|T--|--T-T--|----T----|-T------|---|---T-|-|-|-|-|---|-T---|TT|---|----T--|-|--|------|-||T----T-T--T--------T---|------T---------T--T-T-|--T-|-T--|-||-|-|--|-TT----T----T|------E
XXXXXXXXXXXXXXXXXXXXXXXXXXXXXXXXXXXXXXXXXXXXXXXXXXXXXXXXXXXXXXXXXXXXXXXXXXXXXXXXXXXXXXXXXXXXXXXXXXXXXXXXXXXXXXXXXXXXXXXXXXXXXXXXXXXXXXXXXXXXXXXXXXXXXXXXXXXXXXXXXXXXXXXXXXXXXXXXXXXXXXXXXXXXXXXXXXXXXXXX
