------------X------------------------------------------------------------------------------------------------------------------X---------------?----?------------------BX-----------B-------------------
--------?XM------------X----X------------------------------------------X---------------------------------B---------------------------o------------------------------------------------------------------
---------------------------------------------------X--------------------------------------------------------------B------X-------------B--------------X-------------------------------------------------
--------o----B--------------------?-X-M-----------X------------------------------------------?-------------B-------------------------------------M-----------E------------------------------o-----o-----
--o-------E------------------------------?------------------o--------------------X----------------------------------------------------X----------------------?-----X-------------------------------X----
--------------------------------------E-----------M---B------o-------?-----X----------------E----------------------------------------------------------------X----X---?---------------------------------
-------------------M-------?---------------M-X----------------o----------------------------------------------------?--------------------------------B---------B--B-M---------------------X---E----------
---?---------------??---------B-------------------------?---?--------------------------------------------------------------------XE-E----------------------o-------E----------X-------------o--------X-v
-------------------M---------X-------------X-----------------------------M--------------------------------------oE----M---X-----------------------------?------------------?--------X------------------f
-------X------------------------------------?------------------o----------------------------------XX-------------------------o--Mo--------------M--------------------------------B---------------------f
------M------------------------o----------------?-----------------------M------------------------E------------------------------M-----------------------X---------E--------------------o---------------f
----?--T-----T-----X--------------------------------------------------T-----------------------T---------------------------------X-------------B-----------------------------------------------X----X-?-f
-------|-----|----B---------------M-----------------------------------|-------T---------------|--------------M-----EX--X------------------------o-----------------------------------------M----M----X--f
-------|-----|--------------------------------------------------------|-------|---------------|------------------------------------T---------------T------T--------T---?----------------------o------T-f
m------|-----|----T---T----------------T------------------T-----------|-------|------T--------|---------TT-T-----------------------|---------------|------|-------T|----T-----T-T---T--------T-------|--
XXXXXXXXXXXXXXXXXXXXXXXXXXXXXXXXXXXXXXXXXXXXXXXXXXXXXXXXXXXXXXXXXXXXXXXXXXXXXXXXXXXXXXXXXXXXXXXXXXXXXXXXXXXXXXXXXXXXXXXXXXXXXXXXXXXXXXXXXXXXXXXXXXXXXXXXXXXXXXXXXXXXXXXXXXXXXXXXXXXXXXXXXXXXXXXXXXXXXXXX
