M-??X---oM--M-XE-ME?--E-BEo--B--XEME-X?M-M-oE-XBX-B?-oB-M-E-X--M----?----EXMM--E-X-o--M-o-?MB-Bo--M-B?----X?--o?E-MX-MEEXMX-X-?BB-?-X-E-EoM?o-MXoE-?Eo-EoEoMM----oXE-X??EM-B?-XM---o-o-oM-Eo--oB-XXBo-XE
Eo--E---M-MM--o--EE---X?---o-BMXXX--E-X-XX-----oMBME-XoBME-E---E-o-EB---o?oBo-----Xo-?--XM-?B-o-EE?-BX?-----BEB--X--BB-MEM-E--??-B?XoMM-?--B-XM-MEo---o-BM--oX?---E-M-MMBX-o?-?------oEMM?BMX-oEB-E??M-X
?Bo?o---?-B-?EB?oo--?-Mo---M?EE-E-?---------EB-----EXM-M-oM-o-M-M---XE??-XBo--?o---E-E-?-B-EX---TEoE---BoEMX?XBB-MEEM-X-XoE--?M-BMo--E-EE-M-X---o---EoEM--M-M?-?-----ME-B?-B--E---?--XE--E--??---M--MMMX
|-o-E---?--B----T--E?-X--------X-B-oo------?M--B-------M------------M-X---B----B?---------??----|----?--B-o----X-X-MM-E----TE---?---B----?B-X-----B-------B-----B-XX-?BB-?-oM-M--B-M--?--EoM-------?-?-|
TM---X----?-----|-o--M--BX-?---B--M-?---E-M------T---XX---M-B---E--X---o--E--?-o-----X--?---M-X-X-oB---T---X-M----?---B----|---T---E------E--M------MX-B----o--?-----E---E-o--?MM-?o-E--oEo--X?--Xo?--?B
-?MB-E-M?To--?--|B-----M--M---B--------?-----T--?XX--o-B---E?B-----?-X-EE-BXE---TMB--?-----?-E-o-o-o---XE--oB--o-----??X---|--EX---EXo--------E-?-o-----?o-E-----?-------M?-?---B---E?-?--o--E---------|
E----MT--|--?---|E--------?---B-X-M------X---X-----XE---?--ME--E---?--M-----B-B-XE-X?--MM---M--oB--M-----?---?--E?-Mo-B-o--|-M---o-o-------------XoEX-B---o------B-B--B-------o?M---?B-B--o---XT----M-M-
|-M---X--X------X---E---?-M----------B--o---EBo---?--o-o-M--T-o------X-E----EX-X--XE--B-----------------M------B-----o-----X---XX---------M?--BX---BM-B-----?--E----X-B---X--o-------B---E-M-B-|?B-M--ov
X------------X--------M---------X-----?---o-o--o----Mo--?-M-|--E--?----?-----?-?X----------?-----oXB-----?-?----M----BXo-----?-E---T?--------E-?--?-----X--o-----EX----X?-E----MM--?E-----M----|E-XM--Eo
o-??-----o-E-o-M-------B-M--TM---E--MM?-B---o-T-?------B-??B|-B-?---M----------o------o-?------?-M---EB-B--M---------------------T-|-?-?--Mo--E------------oo-------E--------------B----E?-T--?X-------E
-E--B-o--M-?--BBM-E-X---X---|-EM---ME------MB-X----M---E---B|--X----M----o--X-B--B-?BX------oXM-EM---BE--E?----M--o-oB---M--E-MX-X?XB----M---M-?BM-?-----o?----?-M-oB-EMB-oB--Eoo-EM--?----|-----------?
TEBE-E---E--ME??----------?-X-----T--B-XB?To---?--?T?-X----BXM---------?B-X-----T--?----------Mo--TTM---o--M----------X-B-----?-E------oooXB---ooM--B---X---B-EB-MEM------B----?T---?------|----------B-
X--------?---B-BMX------T---------|--o?--o|-----E--|----T?--B-------------M-B-Bo|--------B?-------X|o-T---------E-MTBB-------o------B---T------------oB----M-B------Mo-X--MB--T-|--M-X-o---|----M-o--M?X
--?-------------oTo--BTT|---------|------?|T--M---T|-oMT|----------------------T|---T---X--M-B----T|--|------------|--------------------|-------T-?-M--T-B--E-----------X-B--X|-|T?-T---T-TX-----------|
m----------T-----|----|||--T------|--TTT--||------||T--||-------T--------------||---|T-T---------T||--|---T---T----|-------------T-T----|------T|------|--T-------------------|-||--|---|T|------------T
XXXXXXXXXXXXXXXXXXXXXXXXXXXXXXXXXXXXXXXXXXXXXXXXXXXXXXXXXXXXXXXXXXXXXXXXXXXXXXXXXXXXXXXXXXXXXXXXXXXXXXXXXXXXXXXXXXXXXXXXXXXXXXXXXXXXXXXXXXXXXXXXXXXXXXXXXXXXXXXXXXXXXXXXXXXXXXXXXXXXXXXXXXXXXXXXXXXXXXXX
