MX-E-----E-X--BE-XM--BMoB--M-EMBoo--oXMoBBE--?oB-?XBEMooB-o-Xooo?-EEE---BM--XB?oE?oB?TX-M-?MMXo---B--Bo-EB--X-oM--B-XXBX-MB-E----EEM--?M-MoB--B--EM-BX-?--?BX-o-XX-X-o-B-o-BX-oXMM??--XME-BM-MB-M-X-E--X
M-Xoo?EBo-oXBB---oXBBE-X-XX-B-oMM??--o?B--XM-B-?-E----B--o-ME-Bo??-M-B--o-EXMo--Bo?EM|M-E?XX-o-oE?MoXMB?-?ooMMB-X-?-X-XX-?-?-TX-BX-X--B-XB----XE--X--X----M-oEEB-XBTME-oMM-oB-X-M----X-M-Bo?--o-o--E---M
E--EM--M-M---X--X-?--E---X-o-oBoBE-?-?X--EMoEMMMMBoB-oM-EM---Bo-MBXT-E--MT-X-EMM-EM-B|o--o-B--X-B-?--MX-E-B?-E?-?BM?X?----E--|MB-?--BB----MEXBM-Xo----E-o?M?B---M-X|--TB-?-Mo?--EE-M-MXE-----?--o?B-ME-E
B-o-B-B--B---E-BX----E--------E-??-M?-------?E-EM---XE-M-Mo-MM--BM-|T--oB|-M---X---X-|--E-M--o----------o?B------?X---M----o-|--X---X----B---X-o-E----------X---E-E|--|E-MX--?Xo--?-----T-?---ET?--X--T|
?------X-B-Mo--------??-B---?B-T---Mo--X-EM-o-?---E--M----oB------E||-?MEX--X-EB-?-o-XX-?---?--M----oM-?B---X--X-E?-MX--EM---X-----M----------?BX---o-B--oo-BoM-o--X--|---E------E--MB--|--X-B-|--?---|T
|E--------EB--?E--X-Mo---oM-M--|-X------To-----BEXE-oE--?---X-MBo--XX-?----B-oE-M-------?-M-BX----XE-M----EE-?E--B-X------TM?Eo--B--B-?o?-oo-?--o---M--X-M--------X---X-B-?-M--------?-E|---?--X-oB--M|o
B---oMo------E-------M---oEE?--XX--X-E--|---M---o-E-?--TBEB-o?--E---M-----M-----------?-T-E---?--B---oo------?-MB--o--X---|-----T---MB-B--B--o------E-----oB-B-B---X-EoB---Xo---X--X--E-|X--?---X--?--|B
E--M---o----?----M-?--E--?---E------B---XX-E--?--B--E-M|--B---------B----BE----XMoT-----|-----B--M-?---B?--o---B---MM--X-oX-M---|-?------M---?E-----?----?--------B--E-M-----M--o---??--X----E----?---Xv
|-B---o------M-------o-----M--B----X------XM--M----X--B|M?-B-B?-B--?--B--E--?--?-MXB---E|-??---BM-?--?---M-B-E----?-?---B-E-----X-E?E--M-?-BX?---o--?-----E--MX--X-oE-----M-BE--?BM-M--B-Xo---BT---E-??T
XEo------MM----------------o----B-X-T?---o-B-XMo-o?----|?---T---?---B?-----EooEB-------o|-?-oX?-M--?M------BM--XB-----M-B-M--------E--oo-----?---M--?X-X-X---o--o----B------oB-------E-MX-E-M--X----To-B
M--o-?-E------?-B--MEoM-o-B-MX----EXX-----X---E----XE--X--?-XEBX------M?-------????---oEXX-----o-E--E-----o--oE-----?--Xo--XE?--B-?M--M--E--M-B-----E---???----?E-o--E?---XB--?-Mo--B---E-T--MX---B-|--X
BT------T---o-------MMB--EM---B---BM----MM?--MB---o---?B-BM---?-E-M---------?---B--B--------XB-------T---T---BTT------M---------M-T-T--X-----X----B---Mo------M-BTT------T--oX---E--M-T-EMX??--?---E|--E
M|------|?--?-----B-----XB---X-M---T------EX------E----?X--------------------?M-BT---T---T----TB---T-|---|--?-||-X-BB-B---B-E-----|-X--M---T----------M-----o-?TMX|-o-BX-X-----E------|?M--M---T----X--E
X|----ET|--T-----------------T-T-T-|--------T-?--------T---------------------T---|-TB|X--|-T--|-B--|-|-T-|----||----T?------------|----MT-o|-------------------|BE|---------------TETT|--------|--T---T|
m|----T||--|-TT-------TT----T|-|-|-|--------|----------|---------------------|---|-|-|---|-|--|----|-|-|-|----||----|-------------|-----|-T|-T--TT-------------|--|----------T---T|-|||-T--T---|--|---|M
XXXXXXXXXXXXXXXXXXXXXXXXXXXXXXXXXXXXXXXXXXXXXXXXXXXXXXXXXXXXXXXXXXXXXXXXXXXXXXXXXXXXXXXXXXXXXXXXXXXXXXXXXXXXXXXXXXXXXXXXXXXXXXXXXXXXXXXXXXXXXXXXXXXXXXXXXXXXXXXXXXXXXXXXXXXXXXXXXXXXXXXXXXXXXXXXXXXXXXXX
