-------------?-------------------------------E------------------------B-------------------------------------------------------B-----------------------------o-------o---------------?----------E--------
------X----------------X---------E------?---------------o-----------------------------------------------------?-------------------------------------------------------B------------------------------X--
----E------------------------------------------------------------X------------------------------------------------------M------------B-M-------------------------------------------------E---------X-M--
-----------------------------------------------------------------------------------------------------------------------------------?----M---------------------------------?----?------------------------
--------------------------------------------------------------E------------------------B-----E----------?---------------------------------------------------------------------------------?-------------
----------B------------------------------------------------------------------X-----------------------M-------------------o------------------------------------------------------------------------------
-----------o---------------M--------o---------M-------------------------------------------------------E------X--------------------------------------------B-----?-?-------------------------------------
------------------------------------------------?-----------------o--B----------------------------------?----o---------------------------B-----------------------o---------M-------------------------X-v
----------------------------------?---------------X--------E------------------------------------------M----------------B--------------------o-----------------------?----------------------------------f
----------------------B---------------------?------------------------------------?-------------------------------------------------------------Xo----------------------------?X------B-----------X-----f
-------------B------------------------------------------------------------M-M------------------------------------------------------------------------------------o-------------------------------------f
----------------------B-------T----M--------------------M--------------------------X--------------B--------------------------X-------------o-----------------------------------------------------------f
--------M---------------------X---------------------------------E-------------E--------------------------------------o-------------?---------------T------------B--------------------M-----------------f
-------------------------------------------------T------------------------------------------------------------------B-----------?---------------o--|-----------------------------------?---------------f
m-X-M-----------o-----X------o------------X---X-XX--------------------------X--------------------------X------X-------------X---XX----------X-X---XX-X--------------X-----------X------?---o--oX-XX-M--f
XXXXXXXXXXXXXXXXXXXXXXXXXXXXXXXXXXXXXXXXXXXXXXXXXXXXXXXXXXXXXXXXXXXXXXXXXXXXXXXXXXXXXXXXXXXXXXXXXXXXXXXXXXXXXXXXXXXXXXXXXXXXXXXXXXXXXXXXXXXXXXXXXXXXXXXXXXXXXXXXXXXXXXXXXXXXXXXXXXXXXXXXXXXXXXXXXXXXXXXX
