EM---XEB--MB-o--BB?M-X--B?oME---MB?-MX----oX---B-B?X-B---XE--o--M-M---XBX??-o-o-BB-EM-oMo-----Mo-?----oBM----Xo???MBBEM-?EXMoE--?-BM--?--MBXBX-MM-----E?E-E-ooMBE?---?M-?E-BMB-EXB--X--?-X-EB?--?--?E-oo
T-o--?-B--BBMM---BB---M-o--X--EB--M-?--EBXX--ME-ooB?o---M---oEo-oX-B-BEEMoB--EEoE----EX--E----X--?M--E--MMX---M?-----EXEBE--o-oBB---E-?----XM-o-?X--EE--oX-E??EX--?---M--o-----o--M-X----oME-M----MM-X-X
?---EE--o??-B-?--X----oBX-----B-o--Xo--o--o----oX-E----Eo--BX---B----B--M----B-BB-X-E-XX-M--Xo-ME-----BXE---B--B?---M-o--XM--o?ME--M?-B--B--X--E?--M--?TEM-o-X---o--?---X---oB-M----o--?B-?---MB--MB?XEo
Mo--M-E--B?--M?E-M------M--?M-XE----------M---E-oMB-------EM-E-E----E---T----?---BE-BEB?-E----E-?-----B-M---oXE--o--B------X------TX-E--o---o-X?-E--E-o|--X--o------B-M-M-?-EE---X?-X--?M----E-XXE-?X--M
-----E--TEME?--?--B------TEE-?-----BMB-------X-o---?---?M--Bo--X--T-Mo-M|-B-B----M-----M------X-?o----ME?----X--E-X--BoX--M-------|---M?--MM-------TM--X-M-M-?---EB---o-------X-?-o--M--M--E----o-B?o?-|
B-Xo----|-E----T-B?--B---|-T?-BB--o----M-----B-o-B?-EM-----oMM?---|??-M-|------X-X--M--?M-o---B-B-?----M?-?----o---T--------------|------ET--M--B-?|-E---B-ME-o-X-----X--EE----oo---M---ooTE-E--?----T-T
E-EBMM--|-?B--B|---Mo---X|-|-B--oM----o-B--M?------E-XEM------o--X|?----|-M-----o---o-o------?----ooX-?BE-X----M-Eo|--M--X--MM----|----BX?|---?--?-|--To----M--X----B--Eo------------B-?-o|B-M--?E---|-|
?Xo--?EET------|X-EMEX-?o|?X---ETX-----o-?-----MB-B?--?o-?--------|-----X--T--E---M?--B-o------M----T-BB------B--o-|oM------------X?X--B--|T-oXBBToX-E|-?-o?-MM?---X--E---M-?---o---------X-E-o-B--o-|Bv
o-?---?-|---E--X---XTo-?-X-?-o?-|--M---M---X-ooM--BT---E-MEM-B----X--------|------E--B---o--?E-B-B-X|-----------M?-X---o-o--X-o---BX--?-X-||----E|M-MM|B---B--B?--B-o--?----?B-X--M-----BE--B-X----B-X-o
o-M-?--o|X----?-E---|-E?------E-|o----X?-E-------?-|---M---------?---o-X--E|?o-oXE?-?M--X-----oB----|X----E-----BM?B-?o--?---?-?MX-?------X|--?E-X---MXM--B-----o---XM?---M-?-----BX---E-o--o?--?--To-oT
Bo-B---oX?--?--M-E--XEE--EBXX-B-|-Xo-----MXX----E--X-E---B-B----o-------M--X-X?-M---BMMM-B---?o--B-o|--M---B------MM?--M-?B-??BE---o--?-?MMXX--E---X-E-MEoM---BMEE-----EoM-X--BM-E--B--M-------o---|B--M
----B--E---Mo--TMB-------?-MBo-?X--------T-------TB-----?------T--------------X-?-------T--------B-oX-B-------?-M---o----T------X------TTT--M?--MB--------?-------M--?---TET---M----------E--B---o-X---T
|--------------|---------o-T-T------ET-X-|T-----T|B---------?--|-------T---E-----------X|--TX-----------T-X---------o-T--|------------E|||T------------T-----------T---BB|-|E-B-----------o-------------
X--T---T----T--|-----------|-|-------|---||-----||----T--------|----T--|T----T--T----TT-X--|------T-----|T-T---T----T-|--|T--T----T----||||----TT------|-T-T-T-T-T-|---T-|-|-------------T-T------T--TTo
m--|---|----|--|-----------|-|-------|---||-----||----|--------|----|--||----|--|----||----|------|-----||-|---|----|-|--||--|----|----||||----||------|-|-|-|-|-|-|---|-|-|-------------|-|------|--||X
XXXXXXXXXXXXXXXXXXXXXXXXXXXXXXXXXXXXXXXXXXXXXXXXXXXXXXXXXXXXXXXXXXXXXXXXXXXXXXXXXXXXXXXXXXXXXXXXXXXXXXXXXXXXXXXXXXXXXXXXXXXXXXXXXXXXXXXXXXXXXXXXXXXXXXXXXXXXXXXXXXXXXXXXXXXXXXXXXXXXXXXXXXXXXXXXXXXXXXXX
