?Mo-EXM-E?--??-E-?-o-BB-X-o-M-o--B??--B-M?-?------oo-?-E---B?--B?E-o-oM---X-MEoM----E---oMM-Bo-B-MX??---BBoo--?B-BB-M-B----MoX-----?X----oo--oM-o---oBM---B?oE?B---ooBo--XM--EM--E?oB-?-?BB-B-XXMB--Xo--
-B-?E?B-----Mo-?--B??o-o?MMBXoo-E-----?o-?-B-EE---M?---B-XToEM--X?B-X---o-?-B-?-oE?-oE-?BBE?--E?oM?M?X?-oo---X-B-----Eo-o-oM-M-o?X--?B---B---Eo---?X-E-o--B-oB---XXo--MMX---oB-BXBM----BooBM-ME--?oE--?-
M?--EM?ooBXEXMo--BMBo-BM----BEoXM----E---XE-------oMMM--EX|----BM----o------B--M?--B-M-o---o?E--??B-?---?XM-?--EM--?XEMo-B-------o--o??-X-B--E-?BX---M-B-EE----M--EMM-M----oB-o--B?-E-MEo?-E-BX-?------T
o------M--T------oM-?M----BM-B-T----B-o-----E?-------T--E-|B--M---------?B-----B----E-?---E----o-o-o-oM--------X-X??o---------------M--?--B--B---M------?B---M--o---?---?o-M----TE--------o-------?E---M
X--X---T--X-B-----??--M-----E--|----?----M----E-o----X---M|-BM?-?B--X---B-----------B-----?---E-X-----B-M?-X--M-----?ME----B-?B--EB----------?E-X---?T-----------Mo-MXEo--?--o--X-------M--o----?----?-E
T---?X-X-T-----o-M--EE--MEB---o|---X-oX---BM---B-----B----X--M---B-----o-E--TT----?----XB---Bo-Bo??T---BoM----------o----?---M--BB-?X-TM-o------o-XX-X-Xo-B------BME-----X--BE----E------B--X--Xo---EB-T
E------Mo|--------E-----E----BTX--o-?--M-o------?-----?M--M---B---M-?---o---X|E-oME-------MX----M-E|-------E--XX--E-?-oE---M-?EEo-----|B---------B---?---E----------MTX-----o---XMBX--o------EEE--o?-o-B
X---B-MTT|-M--M-B-?X----?---oM|-X---o--E-?o-Xo-M-X---o-T---B-o--X-oB--X------X------oX--?X--E-X----X-----oo-E-M-----B-T-B----?BE---X--XM-X?--E--ooMM--M----X---o?--oo|------?----?-T--BB?-BT---?B---X--v
X--EoX-|X|---X-----T-o-o?--X--|--M--E?B-BM-E---E---TXo-|------B------EB-EX---BX-?B-o--T?---M-----?BoEM-B-Bo--E--oXEM--|X-----o---E--MB?----XB-B-o?-BM-BM--EB-o-----o-X-------?o----|-?--E--|-E----M-o??X
B-MB?--X-XM?----B--|-o--B-B--X|-o--?-?B-BE-B-------|--X|-X--M-----MX----?M------M-----X-o--o-oEB--M-------o-?Eo--?----|E-----------B--BB--BEM-M--o----M-M-?-----EEMoE-ME-----?-?---|-------|-o-------?-|
T---ME-E--BE-?-o---XEoBEM--E--Xo-?-----B-M-o---E---X?-MXBE??-?---o--------o?M-?Mo-o---BXE-E?-E--X-----BX-B-----B-----oXo--X-??-oX?X-----E--?o---Eo--Mo---??--?---o--o-ooE--?M-MB---X-X-E-M?|-M-?--E-E--M
XE--------?----M-o-?----------------T----oE-E------o---E------X-X---T-M-----o-T----o------MT------T---------M---T-o------MT-?------X--B--?-M-BX-?-M------o-B-To----E-T-B-o------M---TB---T-To-E-E-T--T-?
--------M-----------X-------T----?--|---B--X------M-E-T-X------B----|-M-M-----|------T-----|------|------?T--ME-|-M-M-----|-------XM--oB-M------TMT-o---M---X|-------|-B-E---E------X--E-|-|---?--|X-|-E
---T----T---ToE----T-----X--|T------|-B-----EE----o-B-|-----B-T-----|----X--BE|------|TM---|--M---|-M-----|-T---|-------o-|-------o--?-----M-E--|?|----------|---TM--|-------------------|-|------|--|-|
m--|----|---|------|--T--T--||----T-|-----T-T---------|T-----T|T----|---------|------||-T-T|------|-------|-|---|-T----T--|---------------------|-|----T-T---|---|---|-------------------|-|------|--|-B
XXXXXXXXXXXXXXXXXXXXXXXXXXXXXXXXXXXXXXXXXXXXXXXXXXXXXXXXXXXXXXXXXXXXXXXXXXXXXXXXXXXXXXXXXXXXXXXXXXXXXXXXXXXXXXXXXXXXXXXXXXXXXXXXXXXXXXXXXXXXXXXXXXXXXXXXXXXXXXXXXXXXXXXXXXXXXXXXXXXXXXXXXXXXXXXXXXXXXXXX
