?E??oo--X??B---?-?-oE-??EE-X?EEX---X-oXM?-oXo--BMMB-X-EXM-XMB-EMo--Xoo-EX-?-MMM-E-X--B----------E---?--Bo-?oX?o-----oB?X?--?-EEXB--EEM?ME-BBM?o-X--?XX?XM?oEB?-M-----X?-EEXX-E---o-MBoB-EE-?-M---?-EE-oT
B--oMoo-XM---?--E?-Eo?M-Xo--M----MMMo-B?---oE-MBBoX---?E-X--M--?Eo-ME---BX-EE---EX?------M-XM--X---??o--?-o-?o---o-B-XB--?X-XBMo-E-BM-?--BXE??XE----BEX---XMo-?--X--oB-MXM-Eo--Bo-ME?--M-M?oBX--X?E----E
M-?---------oXEooBB?M--E------?MB--o-XM-M-BE?--BX--T--B------E---o--oTBBo?o-XMoE-?MB?-Mo--M-----o---Bo-----X--o-o?-E-MMXo?M-XXX-BE?--X?----EBE--E----E---------BB-?--??--o----MM-XX--MBX--M?-XE-?B-MT?-?
TTE--M-o----o---E----B------?---BX-B------E---X-?--|-------------XX--|oMM---------oo----o-X?---------oM?M?EE---TMET-o-X?M---o-o--M----------Mo--E---X--X--EBX-B--?--------------M-X--MT-XB---B-M?---|--o
||-X-E?oX-M-----B----B-E---E----E---M--MM-------M?MX?-----M----M?E-?-X--?B--oX--X?E---B-TM??M?B---?--o----M-oB-|-M|--XM-M--B--?M--M--EX-MB-M-M----X--T-M-EM-o--o----X----XX-XMX----T-MX---M---------X--o
M|E---o-E---?-E---BM--M-M?-E--E--T------M--?B-B--oB-M-o?----B-B--B---B---o------BE--X--B|M-E--E-o-BMo---X---M?-|-?X-----M---o-o-----------B-B------X-|---Mo---M----M--B---Bo---?---|X------M?-?X---o---o
MX-Xo-----oBM-T--------ME-BBMo-o-|-XX-?--E-----B---M-----B----o----oEB--BB--o-X---B-?---|--T--ME---E-E---XBT---X---EX------Eo----XoM---M--M-?----X---|?------Bo----?----EM--X---E--|-----?B----?-E----BM
M------B-----X|-B---?E-B--MEEo---|XM-M---E---B-------B----B---?B--o-MM--------o-ooBB??-M|?-|--------------oX---o-Mo-----TBB--X-?---------T-B--X---o--X-------ME---EB?-o--BoM--B-M-X|----E---?--ToEo----v
B--X-M--E-M-M-|B---?--T--E----B--|----Mo---oX?E--BMM-------XT-E-XE---?--X--B---T------X-X--X-M-B?----B-o---M----B----X-B|Mo--oX--B---XXT?|?----?X---------M-------E---B---o-----E--X-E?-E--X---|-------|
?M--oo--o-----|BB--o--X?-?-----E-X-E?MM-?---T---oE-------B--|---?-E-X---------E|B----?E-E----MX?---?-----------?---X-??-|-M-o??-B---B-BX-X-o-X--M?----?-XMo--------X---?---EoB---------E-XX?-M-|--T--?-T
--B-M-M----o--XM--??--M--o--o?B--o-o-M-----M|B----o--oXo-E--|X---?MEE-B--M-XM--|----o------------M---XB-ME-----o----X-M-|-----o--M---Bo---M-?E---EXX-Xo--B?X-BE--X--E-------??----?-----o-E-E-X|M-|X--XX
XT-BB-ET-M---------?-------o---?-----MB---T-|---To-----B--TB|--BT-B-?X---------XT----E---------M----B---?---------B--?MBXT--??-oo-o--M---Bo-MB-?-E-----B------M---M-T--o-----T-----B--XM---B---X-EX---?-
X|--ETT|--T--o----------E---------?-E-----|-Xo-?|---------|-X-B-|-T-M-----T---M-|?-X------E-----E-M--?--?-----?-T--------|----Eo----B-E--MM---------XToE-M-?E?--oo-o|-T--M--E|----?-----------?o-MM---oX
T|M--|||--|---------o-M-------------------|?----|E--------|-----|-|--T----|---oT|--o-------M-T-T------T---------|--T---T-|-X-T-----MT--?-o-------M---|-----EE-?-T--?|-|-T----|-X-T---------------MT--?-o
m|-T-|||--|------------------------------T|---T-|---T-----|T----|T|--|-T--|----||-T----T--T--|T|T---T-|---T---T-|--|---|-|---|-----T|-TT-------------|----------|---|-|-|----|-T-|--T-T---T----T--|----B
XXXXXXXXXXXXXXXXXXXXXXXXXXXXXXXXXXXXXXXXXXXXXXXXXXXXXXXXXXXXXXXXXXXXXXXXXXXXXXXXXXXXXXXXXXXXXXXXXXXXXXXXXXXXXXXXXXXXXXXXXXXXXXXXXXXXXXXXXXXXXXXXXXXXXXXXXXXXXXXXXXXXXXXXXXXXXXXXXXXXXXXXXXXXXXXXXXXXXXXX
