E-XBMo-BoX-???Xo-ME--oEMMBEX-BEBo-B?--EB-XM-M---EB-oE---B-B-E-MBoX--XX-XoBXBBBEE-XMMB?BXoMoo-?-B-?-B-E---B--Bo-E-EBEB?---oB-EEMoM-MB-MoEMMoXXEXo-?EXX--BX---MoXMM-EB?Bo?-X?E?---??M--XMM--B---o----MEXX?
------B-?o?BE-----------ME-B--M--MX-BEXMoM?-o-?E-Mo-MB--Bo?B?--B-MM--B--E-o-o---MB-E-E-o--E-M-MoM?B---XX-oEEo-BMM-BoE-oM-B-B-X-E?ooB?M-EMB--??-MM--E-M?----oo-EX-o-XBBB-MMX--X-Bo-o-Bo-B-MB-X-E---MEXT-M
|-?-o-BM-o-o?M--oE-MMooMEM?-B-------oM?-B-MoMBEE-BMMXB-EB?TM---E----o?E---Mo--?o-oB---MoE-M-Bo--M-XEMoMX--B?--BB----?Xo------Bo?MM?---X?--MBooXMEo--MB-?--oBBo-?-oMM------o--MMX?EB?X-Eo--?EoB---BE-B|oo
oM--B----Bo----------Eo-B-?-Boo------X---B-?------MB-E----|--E?M-oBB-B---o--??------B-oX---E-?-Bo----o-BM---E---MX---o-B----M--------M--?-?o----M?---E---B-BBEB--M----EME-XB---?-o-?---o-T-----------|o?
Mo-o-?-B-oE-----o?-M-----???--------?---?-----o--E-?B----E|--o-------MX--E-E-B-BM-BE--Eo----------o---MoB-MB--E-----?-E--M-?--------o--o?----?B?-o----B--M-B-?---M-MB?-EB-B-oEX-----MX---XoE-E-E----?XMX
X------oo-E---?-B-?-?--B?---?-?-E--oBE-X?---BMBM--X---?--o|-E--M--E-T-MX-o--------?--B-?X-o---o--EE-?--oB---Eo-----------------E---B-oE-EE?B-E?--o-o---?---?----------------B-EX--?XE--X------B-M-----BM
|?X-?---------?-M-MEoXB------XB-------o----XoM-?MB-X-B-M--X-----M---XM?-X??-E--XX-o-------M--M-MM---MBEE-BB?------------MX--B--o-o--?--EB---B-M-o---M-?--X--Bo---o-?BM?-E-?-o-----B---X?X---X-o--?-----X
E--X-o-EXM--------B--oo-X--E---XMME-?-?----E-M---M--B---X-EXo-M--B-X-----B-M---M-E---?B---------M-EX----------?-----EX----EB-XX-------E-E?----o-oM--------------M---o-MMMB-B-M------E-MB--X--?oM-?X---Mv
E---X--------o?X---------Xo--o-B-oE------oB---E----E-M----M-M----o-E--M-?BM-----E-ooX----BM-M----------B-------X----o-------o---BXX-------E-Bo---------X--E-----?o---M---TB--B--X--M?---X--BX---M--o-BB|
B--?o---------EME-E?o--MX--MM--o-?-o--Mo-oM?--------X-o-oB----To-??B?B---o--BE-M-MBTM--oB---E--------------o--Bo--X------?------BB----?-XM-BM---M---XoT--?o-o-----ME--B--|M----o--B?-----X-B--------XB-M
E---?BE---X---?--M-M-B-----M-MB?---E--B-X---X-------EX----MM-BXE--?B-----?--o--o-E-X-?----M-------------M-?------XBo-E??X-E---Eo----o------M--EXMXEo--X---Mo-M-EE----oE--|-?E-B--------o--B-----o---B--?
Moo-----M--M--M---M---E-?-----E-T--o--oX----E-o--M-E-------?---?-BT--TT-----?-?-B------B-----?----E--EX--o?-XB-----------X-?--?----X-M?------Eo-o---XEM-BB-M-M-----oB??MM-?-MM---BEE----X--T-?-E--B--?-o
--?-B---o----TT?---?oXE-B?E-X---|-E--XBM---E--M-M----M-o--------M-|?XX|----?E----T-B-M-?----B-----B-E------X--E---B?----M----------B--E--Eo--E------?---?E-B-----o----B--X?---MoX---EB--BB-|--E---?-B-?o
EX-XB------M-||---B-MMT-BE-M----|o-B----XXX--o-E---------E---?---M|B--|E-----T-ME|---B----X-M-o-------EM-T--E--E--B--T-E--------ToXE-B-B----E-BM---M------?--B-M-?---?E--oo?-?B--M----?----|-B---B---T-|
m-----------T||-------|---------|---------------------------------|---|--T---|---|-----------------------|----T------|----------|---T---------T-------------T-------T------------------T-T-|---T-----|-|
XXXXXXXXXXXXXXXXXXXXXXXXXXXXXXXXXXXXXXXXXXXXXXXXXXXXXXXXXXXXXXXXXXXXXXXXXXXXXXXXXXXXXXXXXXXXXXXXXXXXXXXXXXXXXXXXXXXXXXXXXXXXXXXXXXXXXXXXXXXXXXXXXXXXXXXXXXXXXXXXXXXXXXXXXXXXXXXXXXXXXXXXXXXXXXXXXXXXXXXX
